dteday,season,yr,mnth,holiday,weekday,workingday,casual,registered,cnt
2011-01-01,1,2011,1,0,6,0,331,654,985
2011-01-02,1,2011,1,0,0,0,131,670,801
2011-01-03,1,2011,1,0,1,1,120,1229,1349
2011-01-04,1,2011,1,0,2,1,108,1454,1562
2011-01-05,1,2011,1,0,3,1,82,1518,1600
2011-01-06,1,2011,1,0,4,1,88,1518,1606
2011-01-07,1,2011,1,0,5,1,148,1362,1510
2011-01-08,1,2011,1,0,6,0,68,891,959
2011-01-09,1,2011,1,0,0,0,54,768,822
2011-01-10,1,2011,1,0,1,1,41,1280,1321
2011-01-11,1,2011,1,0,2,1,43,1220,1263
2011-01-12,1,2011,1,0,3,1,25,1137,1162
2011-01-13,1,2011,1,0,4,1,38,1368,1406
2011-01-14,1,2011,1,0,5,1,54,1367,1421
2011-01-15,1,2011,1,0,6,0,222,1026,1248
2011-01-16,1,2011,1,0,0,0,251,953,1204
2011-01-17,1,2011,1,1,1,0,117,883,1000
2011-01-18,1,2011,1,0,2,1,9,674,683
2011-01-19,1,2011,1,0,3,1,78,1572,1650
2011-01-20,1,2011,1,0,4,1,83,1844,1927
2011-01-21,1,2011,1,0,5,1,75,1468,1543
2011-01-22,1,2011,1,0,6,0,93,888,981
2011-01-23,1,2011,1,0,0,0,150,836,986
2011-01-24,1,2011,1,0,1,1,86,1330,1416
2011-01-25,1,2011,1,0,2,1,186,1799,1985
2011-01-26,1,2011,1,0,3,1,34,472,506
2011-01-27,1,2011,1,0,4,1,15,416,431
2011-01-28,1,2011,1,0,5,1,38,1129,1167
2011-01-29,1,2011,1,0,6,0,123,975,1098
2011-01-30,1,2011,1,0,0,0,140,956,1096
2011-01-31,1,2011,1,0,1,1,42,1459,1501
2011-02-01,1,2011,2,0,2,1,47,1313,1360
2011-02-02,1,2011,2,0,3,1,72,1454,1526
2011-02-03,1,2011,2,0,4,1,61,1489,1550
2011-02-04,1,2011,2,0,5,1,88,1620,1708
2011-02-05,1,2011,2,0,6,0,100,905,1005
2011-02-06,1,2011,2,0,0,0,354,1269,1623
2011-02-07,1,2011,2,0,1,1,120,1592,1712
2011-02-08,1,2011,2,0,2,1,64,1466,1530
2011-02-09,1,2011,2,0,3,1,53,1552,1605
2011-02-10,1,2011,2,0,4,1,47,1491,1538
2011-02-11,1,2011,2,0,5,1,149,1597,1746
2011-02-12,1,2011,2,0,6,0,288,1184,1472
2011-02-13,1,2011,2,0,0,0,397,1192,1589
2011-02-14,1,2011,2,0,1,1,208,1705,1913
2011-02-15,1,2011,2,0,2,1,140,1675,1815
2011-02-16,1,2011,2,0,3,1,218,1897,2115
2011-02-17,1,2011,2,0,4,1,259,2216,2475
2011-02-18,1,2011,2,0,5,1,579,2348,2927
2011-02-19,1,2011,2,0,6,0,532,1103,1635
2011-02-20,1,2011,2,0,0,0,639,1173,1812
2011-02-21,1,2011,2,1,1,0,195,912,1107
2011-02-22,1,2011,2,0,2,1,74,1376,1450
2011-02-23,1,2011,2,0,3,1,139,1778,1917
2011-02-24,1,2011,2,0,4,1,100,1707,1807
2011-02-25,1,2011,2,0,5,1,120,1341,1461
2011-02-26,1,2011,2,0,6,0,424,1545,1969
2011-02-27,1,2011,2,0,0,0,694,1708,2402
2011-02-28,1,2011,2,0,1,1,81,1365,1446
2011-03-01,1,2011,3,0,2,1,137,1714,1851
2011-03-02,1,2011,3,0,3,1,231,1903,2134
2011-03-03,1,2011,3,0,4,1,123,1562,1685
2011-03-04,1,2011,3,0,5,1,214,1730,1944
2011-03-05,1,2011,3,0,6,0,640,1437,2077
2011-03-06,1,2011,3,0,0,0,114,491,605
2011-03-07,1,2011,3,0,1,1,244,1628,1872
2011-03-08,1,2011,3,0,2,1,316,1817,2133
2011-03-09,1,2011,3,0,3,1,191,1700,1891
2011-03-10,1,2011,3,0,4,1,46,577,623
2011-03-11,1,2011,3,0,5,1,247,1730,1977
2011-03-12,1,2011,3,0,6,0,724,1408,2132
2011-03-13,1,2011,3,0,0,0,982,1435,2417
2011-03-14,1,2011,3,0,1,1,359,1687,2046
2011-03-15,1,2011,3,0,2,1,289,1767,2056
2011-03-16,1,2011,3,0,3,1,321,1871,2192
2011-03-17,1,2011,3,0,4,1,424,2320,2744
2011-03-18,1,2011,3,0,5,1,884,2355,3239
2011-03-19,1,2011,3,0,6,0,1424,1693,3117
2011-03-20,1,2011,3,0,0,0,1047,1424,2471
2011-03-21,2,2011,3,0,1,1,401,1676,2077
2011-03-22,2,2011,3,0,2,1,460,2243,2703
2011-03-23,2,2011,3,0,3,1,203,1918,2121
2011-03-24,2,2011,3,0,4,1,166,1699,1865
2011-03-25,2,2011,3,0,5,1,300,1910,2210
2011-03-26,2,2011,3,0,6,0,981,1515,2496
2011-03-27,2,2011,3,0,0,0,472,1221,1693
2011-03-28,2,2011,3,0,1,1,222,1806,2028
2011-03-29,2,2011,3,0,2,1,317,2108,2425
2011-03-30,2,2011,3,0,3,1,168,1368,1536
2011-03-31,2,2011,3,0,4,1,179,1506,1685
2011-04-01,2,2011,4,0,5,1,307,1920,2227
2011-04-02,2,2011,4,0,6,0,898,1354,2252
2011-04-03,2,2011,4,0,0,0,1651,1598,3249
2011-04-04,2,2011,4,0,1,1,734,2381,3115
2011-04-05,2,2011,4,0,2,1,167,1628,1795
2011-04-06,2,2011,4,0,3,1,413,2395,2808
2011-04-07,2,2011,4,0,4,1,571,2570,3141
2011-04-08,2,2011,4,0,5,1,172,1299,1471
2011-04-09,2,2011,4,0,6,0,879,1576,2455
2011-04-10,2,2011,4,0,0,0,1188,1707,2895
2011-04-11,2,2011,4,0,1,1,855,2493,3348
2011-04-12,2,2011,4,0,2,1,257,1777,2034
2011-04-13,2,2011,4,0,3,1,209,1953,2162
2011-04-14,2,2011,4,0,4,1,529,2738,3267
2011-04-15,2,2011,4,1,5,0,642,2484,3126
2011-04-16,2,2011,4,0,6,0,121,674,795
2011-04-17,2,2011,4,0,0,0,1558,2186,3744
2011-04-18,2,2011,4,0,1,1,669,2760,3429
2011-04-19,2,2011,4,0,2,1,409,2795,3204
2011-04-20,2,2011,4,0,3,1,613,3331,3944
2011-04-21,2,2011,4,0,4,1,745,3444,4189
2011-04-22,2,2011,4,0,5,1,177,1506,1683
2011-04-23,2,2011,4,0,6,0,1462,2574,4036
2011-04-24,2,2011,4,0,0,0,1710,2481,4191
2011-04-25,2,2011,4,0,1,1,773,3300,4073
2011-04-26,2,2011,4,0,2,1,678,3722,4400
2011-04-27,2,2011,4,0,3,1,547,3325,3872
2011-04-28,2,2011,4,0,4,1,569,3489,4058
2011-04-29,2,2011,4,0,5,1,878,3717,4595
2011-04-30,2,2011,4,0,6,0,1965,3347,5312
2011-05-01,2,2011,5,0,0,0,1138,2213,3351
2011-05-02,2,2011,5,0,1,1,847,3554,4401
2011-05-03,2,2011,5,0,2,1,603,3848,4451
2011-05-04,2,2011,5,0,3,1,255,2378,2633
2011-05-05,2,2011,5,0,4,1,614,3819,4433
2011-05-06,2,2011,5,0,5,1,894,3714,4608
2011-05-07,2,2011,5,0,6,0,1612,3102,4714
2011-05-08,2,2011,5,0,0,0,1401,2932,4333
2011-05-09,2,2011,5,0,1,1,664,3698,4362
2011-05-10,2,2011,5,0,2,1,694,4109,4803
2011-05-11,2,2011,5,0,3,1,550,3632,4182
2011-05-12,2,2011,5,0,4,1,695,4169,4864
2011-05-13,2,2011,5,0,5,1,692,3413,4105
2011-05-14,2,2011,5,0,6,0,902,2507,3409
2011-05-15,2,2011,5,0,0,0,1582,2971,4553
2011-05-16,2,2011,5,0,1,1,773,3185,3958
2011-05-17,2,2011,5,0,2,1,678,3445,4123
2011-05-18,2,2011,5,0,3,1,536,3319,3855
2011-05-19,2,2011,5,0,4,1,735,3840,4575
2011-05-20,2,2011,5,0,5,1,909,4008,4917
2011-05-21,2,2011,5,0,6,0,2258,3547,5805
2011-05-22,2,2011,5,0,0,0,1576,3084,4660
2011-05-23,2,2011,5,0,1,1,836,3438,4274
2011-05-24,2,2011,5,0,2,1,659,3833,4492
2011-05-25,2,2011,5,0,3,1,740,4238,4978
2011-05-26,2,2011,5,0,4,1,758,3919,4677
2011-05-27,2,2011,5,0,5,1,871,3808,4679
2011-05-28,2,2011,5,0,6,0,2001,2757,4758
2011-05-29,2,2011,5,0,0,0,2355,2433,4788
2011-05-30,2,2011,5,1,1,0,1549,2549,4098
2011-05-31,2,2011,5,0,2,1,673,3309,3982
2011-06-01,2,2011,6,0,3,1,513,3461,3974
2011-06-02,2,2011,6,0,4,1,736,4232,4968
2011-06-03,2,2011,6,0,5,1,898,4414,5312
2011-06-04,2,2011,6,0,6,0,1869,3473,5342
2011-06-05,2,2011,6,0,0,0,1685,3221,4906
2011-06-06,2,2011,6,0,1,1,673,3875,4548
2011-06-07,2,2011,6,0,2,1,763,4070,4833
2011-06-08,2,2011,6,0,3,1,676,3725,4401
2011-06-09,2,2011,6,0,4,1,563,3352,3915
2011-06-10,2,2011,6,0,5,1,815,3771,4586
2011-06-11,2,2011,6,0,6,0,1729,3237,4966
2011-06-12,2,2011,6,0,0,0,1467,2993,4460
2011-06-13,2,2011,6,0,1,1,863,4157,5020
2011-06-14,2,2011,6,0,2,1,727,4164,4891
2011-06-15,2,2011,6,0,3,1,769,4411,5180
2011-06-16,2,2011,6,0,4,1,545,3222,3767
2011-06-17,2,2011,6,0,5,1,863,3981,4844
2011-06-18,2,2011,6,0,6,0,1807,3312,5119
2011-06-19,2,2011,6,0,0,0,1639,3105,4744
2011-06-20,2,2011,6,0,1,1,699,3311,4010
2011-06-21,3,2011,6,0,2,1,774,4061,4835
2011-06-22,3,2011,6,0,3,1,661,3846,4507
2011-06-23,3,2011,6,0,4,1,746,4044,4790
2011-06-24,3,2011,6,0,5,1,969,4022,4991
2011-06-25,3,2011,6,0,6,0,1782,3420,5202
2011-06-26,3,2011,6,0,0,0,1920,3385,5305
2011-06-27,3,2011,6,0,1,1,854,3854,4708
2011-06-28,3,2011,6,0,2,1,732,3916,4648
2011-06-29,3,2011,6,0,3,1,848,4377,5225
2011-06-30,3,2011,6,0,4,1,1027,4488,5515
2011-07-01,3,2011,7,0,5,1,1246,4116,5362
2011-07-02,3,2011,7,0,6,0,2204,2915,5119
2011-07-03,3,2011,7,0,0,0,2282,2367,4649
2011-07-04,3,2011,7,1,1,0,3065,2978,6043
2011-07-05,3,2011,7,0,2,1,1031,3634,4665
2011-07-06,3,2011,7,0,3,1,784,3845,4629
2011-07-07,3,2011,7,0,4,1,754,3838,4592
2011-07-08,3,2011,7,0,5,1,692,3348,4040
2011-07-09,3,2011,7,0,6,0,1988,3348,5336
2011-07-10,3,2011,7,0,0,0,1743,3138,4881
2011-07-11,3,2011,7,0,1,1,723,3363,4086
2011-07-12,3,2011,7,0,2,1,662,3596,4258
2011-07-13,3,2011,7,0,3,1,748,3594,4342
2011-07-14,3,2011,7,0,4,1,888,4196,5084
2011-07-15,3,2011,7,0,5,1,1318,4220,5538
2011-07-16,3,2011,7,0,6,0,2418,3505,5923
2011-07-17,3,2011,7,0,0,0,2006,3296,5302
2011-07-18,3,2011,7,0,1,1,841,3617,4458
2011-07-19,3,2011,7,0,2,1,752,3789,4541
2011-07-20,3,2011,7,0,3,1,644,3688,4332
2011-07-21,3,2011,7,0,4,1,632,3152,3784
2011-07-22,3,2011,7,0,5,1,562,2825,3387
2011-07-23,3,2011,7,0,6,0,987,2298,3285
2011-07-24,3,2011,7,0,0,0,1050,2556,3606
2011-07-25,3,2011,7,0,1,1,568,3272,3840
2011-07-26,3,2011,7,0,2,1,750,3840,4590
2011-07-27,3,2011,7,0,3,1,755,3901,4656
2011-07-28,3,2011,7,0,4,1,606,3784,4390
2011-07-29,3,2011,7,0,5,1,670,3176,3846
2011-07-30,3,2011,7,0,6,0,1559,2916,4475
2011-07-31,3,2011,7,0,0,0,1524,2778,4302
2011-08-01,3,2011,8,0,1,1,729,3537,4266
2011-08-02,3,2011,8,0,2,1,801,4044,4845
2011-08-03,3,2011,8,0,3,1,467,3107,3574
2011-08-04,3,2011,8,0,4,1,799,3777,4576
2011-08-05,3,2011,8,0,5,1,1023,3843,4866
2011-08-06,3,2011,8,0,6,0,1521,2773,4294
2011-08-07,3,2011,8,0,0,0,1298,2487,3785
2011-08-08,3,2011,8,0,1,1,846,3480,4326
2011-08-09,3,2011,8,0,2,1,907,3695,4602
2011-08-10,3,2011,8,0,3,1,884,3896,4780
2011-08-11,3,2011,8,0,4,1,812,3980,4792
2011-08-12,3,2011,8,0,5,1,1051,3854,4905
2011-08-13,3,2011,8,0,6,0,1504,2646,4150
2011-08-14,3,2011,8,0,0,0,1338,2482,3820
2011-08-15,3,2011,8,0,1,1,775,3563,4338
2011-08-16,3,2011,8,0,2,1,721,4004,4725
2011-08-17,3,2011,8,0,3,1,668,4026,4694
2011-08-18,3,2011,8,0,4,1,639,3166,3805
2011-08-19,3,2011,8,0,5,1,797,3356,4153
2011-08-20,3,2011,8,0,6,0,1914,3277,5191
2011-08-21,3,2011,8,0,0,0,1249,2624,3873
2011-08-22,3,2011,8,0,1,1,833,3925,4758
2011-08-23,3,2011,8,0,2,1,1281,4614,5895
2011-08-24,3,2011,8,0,3,1,949,4181,5130
2011-08-25,3,2011,8,0,4,1,435,3107,3542
2011-08-26,3,2011,8,0,5,1,768,3893,4661
2011-08-27,3,2011,8,0,6,0,226,889,1115
2011-08-28,3,2011,8,0,0,0,1415,2919,4334
2011-08-29,3,2011,8,0,1,1,729,3905,4634
2011-08-30,3,2011,8,0,2,1,775,4429,5204
2011-08-31,3,2011,8,0,3,1,688,4370,5058
2011-09-01,3,2011,9,0,4,1,783,4332,5115
2011-09-02,3,2011,9,0,5,1,875,3852,4727
2011-09-03,3,2011,9,0,6,0,1935,2549,4484
2011-09-04,3,2011,9,0,0,0,2521,2419,4940
2011-09-05,3,2011,9,1,1,0,1236,2115,3351
2011-09-06,3,2011,9,0,2,1,204,2506,2710
2011-09-07,3,2011,9,0,3,1,118,1878,1996
2011-09-08,3,2011,9,0,4,1,153,1689,1842
2011-09-09,3,2011,9,0,5,1,417,3127,3544
2011-09-10,3,2011,9,0,6,0,1750,3595,5345
2011-09-11,3,2011,9,0,0,0,1633,3413,5046
2011-09-12,3,2011,9,0,1,1,690,4023,4713
2011-09-13,3,2011,9,0,2,1,701,4062,4763
2011-09-14,3,2011,9,0,3,1,647,4138,4785
2011-09-15,3,2011,9,0,4,1,428,3231,3659
2011-09-16,3,2011,9,0,5,1,742,4018,4760
2011-09-17,3,2011,9,0,6,0,1434,3077,4511
2011-09-18,3,2011,9,0,0,0,1353,2921,4274
2011-09-19,3,2011,9,0,1,1,691,3848,4539
2011-09-20,3,2011,9,0,2,1,438,3203,3641
2011-09-21,3,2011,9,0,3,1,539,3813,4352
2011-09-22,3,2011,9,0,4,1,555,4240,4795
2011-09-23,4,2011,9,0,5,1,258,2137,2395
2011-09-24,4,2011,9,0,6,0,1776,3647,5423
2011-09-25,4,2011,9,0,0,0,1544,3466,5010
2011-09-26,4,2011,9,0,1,1,684,3946,4630
2011-09-27,4,2011,9,0,2,1,477,3643,4120
2011-09-28,4,2011,9,0,3,1,480,3427,3907
2011-09-29,4,2011,9,0,4,1,653,4186,4839
2011-09-30,4,2011,9,0,5,1,830,4372,5202
2011-10-01,4,2011,10,0,6,0,480,1949,2429
2011-10-02,4,2011,10,0,0,0,616,2302,2918
2011-10-03,4,2011,10,0,1,1,330,3240,3570
2011-10-04,4,2011,10,0,2,1,486,3970,4456
2011-10-05,4,2011,10,0,3,1,559,4267,4826
2011-10-06,4,2011,10,0,4,1,639,4126,4765
2011-10-07,4,2011,10,0,5,1,949,4036,4985
2011-10-08,4,2011,10,0,6,0,2235,3174,5409
2011-10-09,4,2011,10,0,0,0,2397,3114,5511
2011-10-10,4,2011,10,1,1,0,1514,3603,5117
2011-10-11,4,2011,10,0,2,1,667,3896,4563
2011-10-12,4,2011,10,0,3,1,217,2199,2416
2011-10-13,4,2011,10,0,4,1,290,2623,2913
2011-10-14,4,2011,10,0,5,1,529,3115,3644
2011-10-15,4,2011,10,0,6,0,1899,3318,5217
2011-10-16,4,2011,10,0,0,0,1748,3293,5041
2011-10-17,4,2011,10,0,1,1,713,3857,4570
2011-10-18,4,2011,10,0,2,1,637,4111,4748
2011-10-19,4,2011,10,0,3,1,254,2170,2424
2011-10-20,4,2011,10,0,4,1,471,3724,4195
2011-10-21,4,2011,10,0,5,1,676,3628,4304
2011-10-22,4,2011,10,0,6,0,1499,2809,4308
2011-10-23,4,2011,10,0,0,0,1619,2762,4381
2011-10-24,4,2011,10,0,1,1,699,3488,4187
2011-10-25,4,2011,10,0,2,1,695,3992,4687
2011-10-26,4,2011,10,0,3,1,404,3490,3894
2011-10-27,4,2011,10,0,4,1,240,2419,2659
2011-10-28,4,2011,10,0,5,1,456,3291,3747
2011-10-29,4,2011,10,0,6,0,57,570,627
2011-10-30,4,2011,10,0,0,0,885,2446,3331
2011-10-31,4,2011,10,0,1,1,362,3307,3669
2011-11-01,4,2011,11,0,2,1,410,3658,4068
2011-11-02,4,2011,11,0,3,1,370,3816,4186
2011-11-03,4,2011,11,0,4,1,318,3656,3974
2011-11-04,4,2011,11,0,5,1,470,3576,4046
2011-11-05,4,2011,11,0,6,0,1156,2770,3926
2011-11-06,4,2011,11,0,0,0,952,2697,3649
2011-11-07,4,2011,11,0,1,1,373,3662,4035
2011-11-08,4,2011,11,0,2,1,376,3829,4205
2011-11-09,4,2011,11,0,3,1,305,3804,4109
2011-11-10,4,2011,11,0,4,1,190,2743,2933
2011-11-11,4,2011,11,1,5,0,440,2928,3368
2011-11-12,4,2011,11,0,6,0,1275,2792,4067
2011-11-13,4,2011,11,0,0,0,1004,2713,3717
2011-11-14,4,2011,11,0,1,1,595,3891,4486
2011-11-15,4,2011,11,0,2,1,449,3746,4195
2011-11-16,4,2011,11,0,3,1,145,1672,1817
2011-11-17,4,2011,11,0,4,1,139,2914,3053
2011-11-18,4,2011,11,0,5,1,245,3147,3392
2011-11-19,4,2011,11,0,6,0,943,2720,3663
2011-11-20,4,2011,11,0,0,0,787,2733,3520
2011-11-21,4,2011,11,0,1,1,220,2545,2765
2011-11-22,4,2011,11,0,2,1,69,1538,1607
2011-11-23,4,2011,11,0,3,1,112,2454,2566
2011-11-24,4,2011,11,1,4,0,560,935,1495
2011-11-25,4,2011,11,0,5,1,1095,1697,2792
2011-11-26,4,2011,11,0,6,0,1249,1819,3068
2011-11-27,4,2011,11,0,0,0,810,2261,3071
2011-11-28,4,2011,11,0,1,1,253,3614,3867
2011-11-29,4,2011,11,0,2,1,96,2818,2914
2011-11-30,4,2011,11,0,3,1,188,3425,3613
2011-12-01,4,2011,12,0,4,1,182,3545,3727
2011-12-02,4,2011,12,0,5,1,268,3672,3940
2011-12-03,4,2011,12,0,6,0,706,2908,3614
2011-12-04,4,2011,12,0,0,0,634,2851,3485
2011-12-05,4,2011,12,0,1,1,233,3578,3811
2011-12-06,4,2011,12,0,2,1,126,2468,2594
2011-12-07,4,2011,12,0,3,1,50,655,705
2011-12-08,4,2011,12,0,4,1,150,3172,3322
2011-12-09,4,2011,12,0,5,1,261,3359,3620
2011-12-10,4,2011,12,0,6,0,502,2688,3190
2011-12-11,4,2011,12,0,0,0,377,2366,2743
2011-12-12,4,2011,12,0,1,1,143,3167,3310
2011-12-13,4,2011,12,0,2,1,155,3368,3523
2011-12-14,4,2011,12,0,3,1,178,3562,3740
2011-12-15,4,2011,12,0,4,1,181,3528,3709
2011-12-16,4,2011,12,0,5,1,178,3399,3577
2011-12-17,4,2011,12,0,6,0,275,2464,2739
2011-12-18,4,2011,12,0,0,0,220,2211,2431
2011-12-19,4,2011,12,0,1,1,260,3143,3403
2011-12-20,4,2011,12,0,2,1,216,3534,3750
2011-12-21,1,2011,12,0,3,1,107,2553,2660
2011-12-22,1,2011,12,0,4,1,227,2841,3068
2011-12-23,1,2011,12,0,5,1,163,2046,2209
2011-12-24,1,2011,12,0,6,0,155,856,1011
2011-12-25,1,2011,12,0,0,0,303,451,754
2011-12-26,1,2011,12,1,1,0,430,887,1317
2011-12-27,1,2011,12,0,2,1,103,1059,1162
2011-12-28,1,2011,12,0,3,1,255,2047,2302
2011-12-29,1,2011,12,0,4,1,254,2169,2423
2011-12-30,1,2011,12,0,5,1,491,2508,2999
2011-12-31,1,2011,12,0,6,0,665,1820,2485
2012-01-01,1,2012,1,0,0,0,686,1608,2294
2012-01-02,1,2012,1,1,1,0,244,1707,1951
2012-01-03,1,2012,1,0,2,1,89,2147,2236
2012-01-04,1,2012,1,0,3,1,95,2273,2368
2012-01-05,1,2012,1,0,4,1,140,3132,3272
2012-01-06,1,2012,1,0,5,1,307,3791,4098
2012-01-07,1,2012,1,0,6,0,1070,3451,4521
2012-01-08,1,2012,1,0,0,0,599,2826,3425
2012-01-09,1,2012,1,0,1,1,106,2270,2376
2012-01-10,1,2012,1,0,2,1,173,3425,3598
2012-01-11,1,2012,1,0,3,1,92,2085,2177
2012-01-12,1,2012,1,0,4,1,269,3828,4097
2012-01-13,1,2012,1,0,5,1,174,3040,3214
2012-01-14,1,2012,1,0,6,0,333,2160,2493
2012-01-15,1,2012,1,0,0,0,284,2027,2311
2012-01-16,1,2012,1,1,1,0,217,2081,2298
2012-01-17,1,2012,1,0,2,1,127,2808,2935
2012-01-18,1,2012,1,0,3,1,109,3267,3376
2012-01-19,1,2012,1,0,4,1,130,3162,3292
2012-01-20,1,2012,1,0,5,1,115,3048,3163
2012-01-21,1,2012,1,0,6,0,67,1234,1301
2012-01-22,1,2012,1,0,0,0,196,1781,1977
2012-01-23,1,2012,1,0,1,1,145,2287,2432
2012-01-24,1,2012,1,0,2,1,439,3900,4339
2012-01-25,1,2012,1,0,3,1,467,3803,4270
2012-01-26,1,2012,1,0,4,1,244,3831,4075
2012-01-27,1,2012,1,0,5,1,269,3187,3456
2012-01-28,1,2012,1,0,6,0,775,3248,4023
2012-01-29,1,2012,1,0,0,0,558,2685,3243
2012-01-30,1,2012,1,0,1,1,126,3498,3624
2012-01-31,1,2012,1,0,2,1,324,4185,4509
2012-02-01,1,2012,2,0,3,1,304,4275,4579
2012-02-02,1,2012,2,0,4,1,190,3571,3761
2012-02-03,1,2012,2,0,5,1,310,3841,4151
2012-02-04,1,2012,2,0,6,0,384,2448,2832
2012-02-05,1,2012,2,0,0,0,318,2629,2947
2012-02-06,1,2012,2,0,1,1,206,3578,3784
2012-02-07,1,2012,2,0,2,1,199,4176,4375
2012-02-08,1,2012,2,0,3,1,109,2693,2802
2012-02-09,1,2012,2,0,4,1,163,3667,3830
2012-02-10,1,2012,2,0,5,1,227,3604,3831
2012-02-11,1,2012,2,0,6,0,192,1977,2169
2012-02-12,1,2012,2,0,0,0,73,1456,1529
2012-02-13,1,2012,2,0,1,1,94,3328,3422
2012-02-14,1,2012,2,0,2,1,135,3787,3922
2012-02-15,1,2012,2,0,3,1,141,4028,4169
2012-02-16,1,2012,2,0,4,1,74,2931,3005
2012-02-17,1,2012,2,0,5,1,349,3805,4154
2012-02-18,1,2012,2,0,6,0,1435,2883,4318
2012-02-19,1,2012,2,0,0,0,618,2071,2689
2012-02-20,1,2012,2,1,1,0,502,2627,3129
2012-02-21,1,2012,2,0,2,1,163,3614,3777
2012-02-22,1,2012,2,0,3,1,394,4379,4773
2012-02-23,1,2012,2,0,4,1,516,4546,5062
2012-02-24,1,2012,2,0,5,1,246,3241,3487
2012-02-25,1,2012,2,0,6,0,317,2415,2732
2012-02-26,1,2012,2,0,0,0,515,2874,3389
2012-02-27,1,2012,2,0,1,1,253,4069,4322
2012-02-28,1,2012,2,0,2,1,229,4134,4363
2012-02-29,1,2012,2,0,3,1,65,1769,1834
2012-03-01,1,2012,3,0,4,1,325,4665,4990
2012-03-02,1,2012,3,0,5,1,246,2948,3194
2012-03-03,1,2012,3,0,6,0,956,3110,4066
2012-03-04,1,2012,3,0,0,0,710,2713,3423
2012-03-05,1,2012,3,0,1,1,203,3130,3333
2012-03-06,1,2012,3,0,2,1,221,3735,3956
2012-03-07,1,2012,3,0,3,1,432,4484,4916
2012-03-08,1,2012,3,0,4,1,486,4896,5382
2012-03-09,1,2012,3,0,5,1,447,4122,4569
2012-03-10,1,2012,3,0,6,0,968,3150,4118
2012-03-11,1,2012,3,0,0,0,1658,3253,4911
2012-03-12,1,2012,3,0,1,1,838,4460,5298
2012-03-13,1,2012,3,0,2,1,762,5085,5847
2012-03-14,1,2012,3,0,3,1,997,5315,6312
2012-03-15,1,2012,3,0,4,1,1005,5187,6192
2012-03-16,1,2012,3,0,5,1,548,3830,4378
2012-03-17,1,2012,3,0,6,0,3155,4681,7836
2012-03-18,1,2012,3,0,0,0,2207,3685,5892
2012-03-19,1,2012,3,0,1,1,982,5171,6153
2012-03-20,1,2012,3,0,2,1,1051,5042,6093
2012-03-21,2,2012,3,0,3,1,1122,5108,6230
2012-03-22,2,2012,3,0,4,1,1334,5537,6871
2012-03-23,2,2012,3,0,5,1,2469,5893,8362
2012-03-24,2,2012,3,0,6,0,1033,2339,3372
2012-03-25,2,2012,3,0,0,0,1532,3464,4996
2012-03-26,2,2012,3,0,1,1,795,4763,5558
2012-03-27,2,2012,3,0,2,1,531,4571,5102
2012-03-28,2,2012,3,0,3,1,674,5024,5698
2012-03-29,2,2012,3,0,4,1,834,5299,6133
2012-03-30,2,2012,3,0,5,1,796,4663,5459
2012-03-31,2,2012,3,0,6,0,2301,3934,6235
2012-04-01,2,2012,4,0,0,0,2347,3694,6041
2012-04-02,2,2012,4,0,1,1,1208,4728,5936
2012-04-03,2,2012,4,0,2,1,1348,5424,6772
2012-04-04,2,2012,4,0,3,1,1058,5378,6436
2012-04-05,2,2012,4,0,4,1,1192,5265,6457
2012-04-06,2,2012,4,0,5,1,1807,4653,6460
2012-04-07,2,2012,4,0,6,0,3252,3605,6857
2012-04-08,2,2012,4,0,0,0,2230,2939,5169
2012-04-09,2,2012,4,0,1,1,905,4680,5585
2012-04-10,2,2012,4,0,2,1,819,5099,5918
2012-04-11,2,2012,4,0,3,1,482,4380,4862
2012-04-12,2,2012,4,0,4,1,663,4746,5409
2012-04-13,2,2012,4,0,5,1,1252,5146,6398
2012-04-14,2,2012,4,0,6,0,2795,4665,7460
2012-04-15,2,2012,4,0,0,0,2846,4286,7132
2012-04-16,2,2012,4,1,1,0,1198,5172,6370
2012-04-17,2,2012,4,0,2,1,989,5702,6691
2012-04-18,2,2012,4,0,3,1,347,4020,4367
2012-04-19,2,2012,4,0,4,1,846,5719,6565
2012-04-20,2,2012,4,0,5,1,1340,5950,7290
2012-04-21,2,2012,4,0,6,0,2541,4083,6624
2012-04-22,2,2012,4,0,0,0,120,907,1027
2012-04-23,2,2012,4,0,1,1,195,3019,3214
2012-04-24,2,2012,4,0,2,1,518,5115,5633
2012-04-25,2,2012,4,0,3,1,655,5541,6196
2012-04-26,2,2012,4,0,4,1,475,4551,5026
2012-04-27,2,2012,4,0,5,1,1014,5219,6233
2012-04-28,2,2012,4,0,6,0,1120,3100,4220
2012-04-29,2,2012,4,0,0,0,2229,4075,6304
2012-04-30,2,2012,4,0,1,1,665,4907,5572
2012-05-01,2,2012,5,0,2,1,653,5087,5740
2012-05-02,2,2012,5,0,3,1,667,5502,6169
2012-05-03,2,2012,5,0,4,1,764,5657,6421
2012-05-04,2,2012,5,0,5,1,1069,5227,6296
2012-05-05,2,2012,5,0,6,0,2496,4387,6883
2012-05-06,2,2012,5,0,0,0,2135,4224,6359
2012-05-07,2,2012,5,0,1,1,1008,5265,6273
2012-05-08,2,2012,5,0,2,1,738,4990,5728
2012-05-09,2,2012,5,0,3,1,620,4097,4717
2012-05-10,2,2012,5,0,4,1,1026,5546,6572
2012-05-11,2,2012,5,0,5,1,1319,5711,7030
2012-05-12,2,2012,5,0,6,0,2622,4807,7429
2012-05-13,2,2012,5,0,0,0,2172,3946,6118
2012-05-14,2,2012,5,0,1,1,342,2501,2843
2012-05-15,2,2012,5,0,2,1,625,4490,5115
2012-05-16,2,2012,5,0,3,1,991,6433,7424
2012-05-17,2,2012,5,0,4,1,1242,6142,7384
2012-05-18,2,2012,5,0,5,1,1521,6118,7639
2012-05-19,2,2012,5,0,6,0,3410,4884,8294
2012-05-20,2,2012,5,0,0,0,2704,4425,7129
2012-05-21,2,2012,5,0,1,1,630,3729,4359
2012-05-22,2,2012,5,0,2,1,819,5254,6073
2012-05-23,2,2012,5,0,3,1,766,4494,5260
2012-05-24,2,2012,5,0,4,1,1059,5711,6770
2012-05-25,2,2012,5,0,5,1,1417,5317,6734
2012-05-26,2,2012,5,0,6,0,2855,3681,6536
2012-05-27,2,2012,5,0,0,0,3283,3308,6591
2012-05-28,2,2012,5,1,1,0,2557,3486,6043
2012-05-29,2,2012,5,0,2,1,880,4863,5743
2012-05-30,2,2012,5,0,3,1,745,6110,6855
2012-05-31,2,2012,5,0,4,1,1100,6238,7338
2012-06-01,2,2012,6,0,5,1,533,3594,4127
2012-06-02,2,2012,6,0,6,0,2795,5325,8120
2012-06-03,2,2012,6,0,0,0,2494,5147,7641
2012-06-04,2,2012,6,0,1,1,1071,5927,6998
2012-06-05,2,2012,6,0,2,1,968,6033,7001
2012-06-06,2,2012,6,0,3,1,1027,6028,7055
2012-06-07,2,2012,6,0,4,1,1038,6456,7494
2012-06-08,2,2012,6,0,5,1,1488,6248,7736
2012-06-09,2,2012,6,0,6,0,2708,4790,7498
2012-06-10,2,2012,6,0,0,0,2224,4374,6598
2012-06-11,2,2012,6,0,1,1,1017,5647,6664
2012-06-12,2,2012,6,0,2,1,477,4495,4972
2012-06-13,2,2012,6,0,3,1,1173,6248,7421
2012-06-14,2,2012,6,0,4,1,1180,6183,7363
2012-06-15,2,2012,6,0,5,1,1563,6102,7665
2012-06-16,2,2012,6,0,6,0,2963,4739,7702
2012-06-17,2,2012,6,0,0,0,2634,4344,6978
2012-06-18,2,2012,6,0,1,1,653,4446,5099
2012-06-19,2,2012,6,0,2,1,968,5857,6825
2012-06-20,2,2012,6,0,3,1,872,5339,6211
2012-06-21,3,2012,6,0,4,1,778,5127,5905
2012-06-22,3,2012,6,0,5,1,964,4859,5823
2012-06-23,3,2012,6,0,6,0,2657,4801,7458
2012-06-24,3,2012,6,0,0,0,2551,4340,6891
2012-06-25,3,2012,6,0,1,1,1139,5640,6779
2012-06-26,3,2012,6,0,2,1,1077,6365,7442
2012-06-27,3,2012,6,0,3,1,1077,6258,7335
2012-06-28,3,2012,6,0,4,1,921,5958,6879
2012-06-29,3,2012,6,0,5,1,829,4634,5463
2012-06-30,3,2012,6,0,6,0,1455,4232,5687
2012-07-01,3,2012,7,0,0,0,1421,4110,5531
2012-07-02,3,2012,7,0,1,1,904,5323,6227
2012-07-03,3,2012,7,0,2,1,1052,5608,6660
2012-07-04,3,2012,7,1,3,0,2562,4841,7403
2012-07-05,3,2012,7,0,4,1,1405,4836,6241
2012-07-06,3,2012,7,0,5,1,1366,4841,6207
2012-07-07,3,2012,7,0,6,0,1448,3392,4840
2012-07-08,3,2012,7,0,0,0,1203,3469,4672
2012-07-09,3,2012,7,0,1,1,998,5571,6569
2012-07-10,3,2012,7,0,2,1,954,5336,6290
2012-07-11,3,2012,7,0,3,1,975,6289,7264
2012-07-12,3,2012,7,0,4,1,1032,6414,7446
2012-07-13,3,2012,7,0,5,1,1511,5988,7499
2012-07-14,3,2012,7,0,6,0,2355,4614,6969
2012-07-15,3,2012,7,0,0,0,1920,4111,6031
2012-07-16,3,2012,7,0,1,1,1088,5742,6830
2012-07-17,3,2012,7,0,2,1,921,5865,6786
2012-07-18,3,2012,7,0,3,1,799,4914,5713
2012-07-19,3,2012,7,0,4,1,888,5703,6591
2012-07-20,3,2012,7,0,5,1,747,5123,5870
2012-07-21,3,2012,7,0,6,0,1264,3195,4459
2012-07-22,3,2012,7,0,0,0,2544,4866,7410
2012-07-23,3,2012,7,0,1,1,1135,5831,6966
2012-07-24,3,2012,7,0,2,1,1140,6452,7592
2012-07-25,3,2012,7,0,3,1,1383,6790,8173
2012-07-26,3,2012,7,0,4,1,1036,5825,6861
2012-07-27,3,2012,7,0,5,1,1259,5645,6904
2012-07-28,3,2012,7,0,6,0,2234,4451,6685
2012-07-29,3,2012,7,0,0,0,2153,4444,6597
2012-07-30,3,2012,7,0,1,1,1040,6065,7105
2012-07-31,3,2012,7,0,2,1,968,6248,7216
2012-08-01,3,2012,8,0,3,1,1074,6506,7580
2012-08-02,3,2012,8,0,4,1,983,6278,7261
2012-08-03,3,2012,8,0,5,1,1328,5847,7175
2012-08-04,3,2012,8,0,6,0,2345,4479,6824
2012-08-05,3,2012,8,0,0,0,1707,3757,5464
2012-08-06,3,2012,8,0,1,1,1233,5780,7013
2012-08-07,3,2012,8,0,2,1,1278,5995,7273
2012-08-08,3,2012,8,0,3,1,1263,6271,7534
2012-08-09,3,2012,8,0,4,1,1196,6090,7286
2012-08-10,3,2012,8,0,5,1,1065,4721,5786
2012-08-11,3,2012,8,0,6,0,2247,4052,6299
2012-08-12,3,2012,8,0,0,0,2182,4362,6544
2012-08-13,3,2012,8,0,1,1,1207,5676,6883
2012-08-14,3,2012,8,0,2,1,1128,5656,6784
2012-08-15,3,2012,8,0,3,1,1198,6149,7347
2012-08-16,3,2012,8,0,4,1,1338,6267,7605
2012-08-17,3,2012,8,0,5,1,1483,5665,7148
2012-08-18,3,2012,8,0,6,0,2827,5038,7865
2012-08-19,3,2012,8,0,0,0,1208,3341,4549
2012-08-20,3,2012,8,0,1,1,1026,5504,6530
2012-08-21,3,2012,8,0,2,1,1081,5925,7006
2012-08-22,3,2012,8,0,3,1,1094,6281,7375
2012-08-23,3,2012,8,0,4,1,1363,6402,7765
2012-08-24,3,2012,8,0,5,1,1325,6257,7582
2012-08-25,3,2012,8,0,6,0,1829,4224,6053
2012-08-26,3,2012,8,0,0,0,1483,3772,5255
2012-08-27,3,2012,8,0,1,1,989,5928,6917
2012-08-28,3,2012,8,0,2,1,935,6105,7040
2012-08-29,3,2012,8,0,3,1,1177,6520,7697
2012-08-30,3,2012,8,0,4,1,1172,6541,7713
2012-08-31,3,2012,8,0,5,1,1433,5917,7350
2012-09-01,3,2012,9,0,6,0,2352,3788,6140
2012-09-02,3,2012,9,0,0,0,2613,3197,5810
2012-09-03,3,2012,9,1,1,0,1965,4069,6034
2012-09-04,3,2012,9,0,2,1,867,5997,6864
2012-09-05,3,2012,9,0,3,1,832,6280,7112
2012-09-06,3,2012,9,0,4,1,611,5592,6203
2012-09-07,3,2012,9,0,5,1,1045,6459,7504
2012-09-08,3,2012,9,0,6,0,1557,4419,5976
2012-09-09,3,2012,9,0,0,0,2570,5657,8227
2012-09-10,3,2012,9,0,1,1,1118,6407,7525
2012-09-11,3,2012,9,0,2,1,1070,6697,7767
2012-09-12,3,2012,9,0,3,1,1050,6820,7870
2012-09-13,3,2012,9,0,4,1,1054,6750,7804
2012-09-14,3,2012,9,0,5,1,1379,6630,8009
2012-09-15,3,2012,9,0,6,0,3160,5554,8714
2012-09-16,3,2012,9,0,0,0,2166,5167,7333
2012-09-17,3,2012,9,0,1,1,1022,5847,6869
2012-09-18,3,2012,9,0,2,1,371,3702,4073
2012-09-19,3,2012,9,0,3,1,788,6803,7591
2012-09-20,3,2012,9,0,4,1,939,6781,7720
2012-09-21,3,2012,9,0,5,1,1250,6917,8167
2012-09-22,3,2012,9,0,6,0,2512,5883,8395
2012-09-23,4,2012,9,0,0,0,2454,5453,7907
2012-09-24,4,2012,9,0,1,1,1001,6435,7436
2012-09-25,4,2012,9,0,2,1,845,6693,7538
2012-09-26,4,2012,9,0,3,1,787,6946,7733
2012-09-27,4,2012,9,0,4,1,751,6642,7393
2012-09-28,4,2012,9,0,5,1,1045,6370,7415
2012-09-29,4,2012,9,0,6,0,2589,5966,8555
2012-09-30,4,2012,9,0,0,0,2015,4874,6889
2012-10-01,4,2012,10,0,1,1,763,6015,6778
2012-10-02,4,2012,10,0,2,1,315,4324,4639
2012-10-03,4,2012,10,0,3,1,728,6844,7572
2012-10-04,4,2012,10,0,4,1,891,6437,7328
2012-10-05,4,2012,10,0,5,1,1516,6640,8156
2012-10-06,4,2012,10,0,6,0,3031,4934,7965
2012-10-07,4,2012,10,0,0,0,781,2729,3510
2012-10-08,4,2012,10,1,1,0,874,4604,5478
2012-10-09,4,2012,10,0,2,1,601,5791,6392
2012-10-10,4,2012,10,0,3,1,780,6911,7691
2012-10-11,4,2012,10,0,4,1,834,6736,7570
2012-10-12,4,2012,10,0,5,1,1060,6222,7282
2012-10-13,4,2012,10,0,6,0,2252,4857,7109
2012-10-14,4,2012,10,0,0,0,2080,4559,6639
2012-10-15,4,2012,10,0,1,1,760,5115,5875
2012-10-16,4,2012,10,0,2,1,922,6612,7534
2012-10-17,4,2012,10,0,3,1,979,6482,7461
2012-10-18,4,2012,10,0,4,1,1008,6501,7509
2012-10-19,4,2012,10,0,5,1,753,4671,5424
2012-10-20,4,2012,10,0,6,0,2806,5284,8090
2012-10-21,4,2012,10,0,0,0,2132,4692,6824
2012-10-22,4,2012,10,0,1,1,830,6228,7058
2012-10-23,4,2012,10,0,2,1,841,6625,7466
2012-10-24,4,2012,10,0,3,1,795,6898,7693
2012-10-25,4,2012,10,0,4,1,875,6484,7359
2012-10-26,4,2012,10,0,5,1,1182,6262,7444
2012-10-27,4,2012,10,0,6,0,2643,5209,7852
2012-10-28,4,2012,10,0,0,0,998,3461,4459
2012-10-29,4,2012,10,0,1,1,2,20,22
2012-10-30,4,2012,10,0,2,1,87,1009,1096
2012-10-31,4,2012,10,0,3,1,419,5147,5566
2012-11-01,4,2012,11,0,4,1,466,5520,5986
2012-11-02,4,2012,11,0,5,1,618,5229,5847
2012-11-03,4,2012,11,0,6,0,1029,4109,5138
2012-11-04,4,2012,11,0,0,0,1201,3906,5107
2012-11-05,4,2012,11,0,1,1,378,4881,5259
2012-11-06,4,2012,11,0,2,1,466,5220,5686
2012-11-07,4,2012,11,0,3,1,326,4709,5035
2012-11-08,4,2012,11,0,4,1,340,4975,5315
2012-11-09,4,2012,11,0,5,1,709,5283,5992
2012-11-10,4,2012,11,0,6,0,2090,4446,6536
2012-11-11,4,2012,11,0,0,0,2290,4562,6852
2012-11-12,4,2012,11,1,1,0,1097,5172,6269
2012-11-13,4,2012,11,0,2,1,327,3767,4094
2012-11-14,4,2012,11,0,3,1,373,5122,5495
2012-11-15,4,2012,11,0,4,1,320,5125,5445
2012-11-16,4,2012,11,0,5,1,484,5214,5698
2012-11-17,4,2012,11,0,6,0,1313,4316,5629
2012-11-18,4,2012,11,0,0,0,922,3747,4669
2012-11-19,4,2012,11,0,1,1,449,5050,5499
2012-11-20,4,2012,11,0,2,1,534,5100,5634
2012-11-21,4,2012,11,0,3,1,615,4531,5146
2012-11-22,4,2012,11,1,4,0,955,1470,2425
2012-11-23,4,2012,11,0,5,1,1603,2307,3910
2012-11-24,4,2012,11,0,6,0,532,1745,2277
2012-11-25,4,2012,11,0,0,0,309,2115,2424
2012-11-26,4,2012,11,0,1,1,337,4750,5087
2012-11-27,4,2012,11,0,2,1,123,3836,3959
2012-11-28,4,2012,11,0,3,1,198,5062,5260
2012-11-29,4,2012,11,0,4,1,243,5080,5323
2012-11-30,4,2012,11,0,5,1,362,5306,5668
2012-12-01,4,2012,12,0,6,0,951,4240,5191
2012-12-02,4,2012,12,0,0,0,892,3757,4649
2012-12-03,4,2012,12,0,1,1,555,5679,6234
2012-12-04,4,2012,12,0,2,1,551,6055,6606
2012-12-05,4,2012,12,0,3,1,331,5398,5729
2012-12-06,4,2012,12,0,4,1,340,5035,5375
2012-12-07,4,2012,12,0,5,1,349,4659,5008
2012-12-08,4,2012,12,0,6,0,1153,4429,5582
2012-12-09,4,2012,12,0,0,0,441,2787,3228
2012-12-10,4,2012,12,0,1,1,329,4841,5170
2012-12-11,4,2012,12,0,2,1,282,5219,5501
2012-12-12,4,2012,12,0,3,1,310,5009,5319
2012-12-13,4,2012,12,0,4,1,425,5107,5532
2012-12-14,4,2012,12,0,5,1,429,5182,5611
2012-12-15,4,2012,12,0,6,0,767,4280,5047
2012-12-16,4,2012,12,0,0,0,538,3248,3786
2012-12-17,4,2012,12,0,1,1,212,4373,4585
2012-12-18,4,2012,12,0,2,1,433,5124,5557
2012-12-19,4,2012,12,0,3,1,333,4934,5267
2012-12-20,4,2012,12,0,4,1,314,3814,4128
2012-12-21,1,2012,12,0,5,1,221,3402,3623
2012-12-22,1,2012,12,0,6,0,205,1544,1749
2012-12-23,1,2012,12,0,0,0,408,1379,1787
2012-12-24,1,2012,12,0,1,1,174,746,920
2012-12-25,1,2012,12,1,2,0,440,573,1013
2012-12-26,1,2012,12,0,3,1,9,432,441
2012-12-27,1,2012,12,0,4,1,247,1867,2114
2012-12-28,1,2012,12,0,5,1,644,2451,3095
2012-12-29,1,2012,12,0,6,0,159,1182,1341
2012-12-30,1,2012,12,0,0,0,364,1432,1796
2012-12-31,1,2012,12,0,1,1,439,2290,2729
2013-01-01,1,2013,1,1,1,0,421,1543,1964
2013-01-02,1,2013,1,0,2,1,284,3389,3673
2013-01-03,1,2013,1,0,3,1,297,3547,3844
2013-01-04,1,2013,1,0,4,1,297,3781,4078
2013-01-05,1,2013,1,0,5,1,509,3007,3516
2013-01-06,1,2013,1,0,6,0,585,3166,3751
2013-01-07,1,2013,1,0,0,0,332,4409,4741
2013-01-08,1,2013,1,0,1,1,442,4832,5274
2013-01-09,1,2013,1,0,2,1,356,4754,5110
2013-01-10,1,2013,1,0,3,1,359,5023,5382
2013-01-11,1,2013,1,0,4,1,254,3840,4094
2013-01-12,1,2013,1,0,5,1,1239,4334,5573
2013-01-13,1,2013,1,0,6,0,834,3280,4114
2013-01-14,1,2013,1,0,0,0,444,4579,5023
2013-01-15,1,2013,1,0,1,1,224,2673,2897
2013-01-16,1,2013,1,0,2,1,197,3280,3477
2013-01-17,1,2013,1,0,3,1,361,4408,4769
2013-01-18,1,2013,1,0,4,1,340,4132,4472
2013-01-19,1,2013,1,0,5,1,1199,3719,4918
2013-01-20,1,2013,1,0,6,0,1656,4043,5699
2013-01-21,1,2013,1,1,0,0,1026,3500,4526
2013-01-22,1,2013,1,0,1,1,89,2842,2931
2013-01-23,1,2013,1,0,2,1,69,3115,3184
2013-01-24,1,2013,1,0,3,1,20,2405,2425
2013-01-25,1,2013,1,0,4,1,44,2310,2354
2013-01-26,1,2013,1,0,5,1,179,2560,2739
2013-01-27,1,2013,1,0,6,0,263,2726,2989
2013-01-28,1,2013,1,0,0,0,65,2647,2712
2013-01-29,1,2013,1,0,1,1,321,5470,5791
2013-01-30,1,2013,1,0,2,1,182,4460,4642
2013-01-31,1,2013,1,0,3,1,120,4205,4325
2013-02-01,1,2013,2,0,4,1,84,3077,3161
2013-02-02,1,2013,2,0,5,1,233,2217,2450
2013-02-03,1,2013,2,0,6,0,185,2370,2555
2013-02-04,1,2013,2,0,0,0,122,3797,3919
2013-02-05,1,2013,2,0,1,1,151,4427,4578
2013-02-06,1,2013,2,0,2,1,179,4692,4871
2013-02-07,1,2013,2,0,3,1,175,4263,4438
2013-02-08,1,2013,2,0,4,1,146,3205,3351
2013-02-09,1,2013,2,0,5,1,424,3004,3428
2013-02-10,1,2013,2,0,6,0,501,3075,3576
2013-02-11,1,2013,2,0,0,0,151,4071,4222
2013-02-12,1,2013,2,0,1,1,281,5342,5623
2013-02-13,1,2013,2,0,2,1,171,3362,3533
2013-02-14,1,2013,2,0,3,1,355,4762,5117
2013-02-15,1,2013,2,0,4,1,683,4632,5315
2013-02-16,1,2013,2,0,5,1,679,2526,3205
2013-02-17,1,2013,2,0,6,0,483,2004,2487
2013-02-18,1,2013,2,1,0,0,534,2786,3320
2013-02-19,1,2013,2,0,1,1,163,3769,3932
2013-02-20,1,2013,2,0,2,1,190,4162,4352
2013-02-21,1,2013,2,0,3,1,187,3922,4109
2013-02-22,1,2013,2,0,4,1,123,3403,3526
2013-02-23,1,2013,2,0,5,1,211,2336,2547
2013-02-24,1,2013,2,0,6,0,846,3479,4325
2013-02-25,1,2013,2,0,0,0,331,4617,4948
2013-02-26,1,2013,2,0,1,1,149,2593,2742
2013-02-27,1,2013,2,0,2,1,363,5025,5388
2013-02-28,1,2013,2,0,3,1,296,4788,5084
2013-03-01,1,2013,3,0,4,1,329,4557,4886
2013-03-02,1,2013,3,0,5,1,674,3033,3707
2013-03-03,1,2013,3,0,6,0,475,2573,3048
2013-03-04,1,2013,3,0,0,0,311,4101,4412
2013-03-05,1,2013,3,0,1,1,444,4737,5181
2013-03-06,1,2013,3,0,2,1,79,1046,1125
2013-03-07,1,2013,3,0,3,1,315,4691,5006
2013-03-08,1,2013,3,0,4,1,410,4425,4835
2013-03-09,1,2013,3,0,5,1,2168,4600,6768
2013-03-10,1,2013,3,0,6,0,2328,4436,6764
2013-03-11,1,2013,3,0,0,0,1026,5013,6039
2013-03-12,1,2013,3,0,1,1,449,3796,4245
2013-03-13,1,2013,3,0,2,1,625,5068,5693
2013-03-14,1,2013,3,0,3,1,440,4386,4826
2013-03-15,1,2013,3,0,4,1,1201,5129,6330
2013-03-16,1,2013,3,0,5,1,1811,4357,6168
2013-03-17,1,2013,3,0,6,0,982,2960,3942
2013-03-18,1,2013,3,0,0,0,248,2499,2747
2013-03-19,1,2013,3,0,1,1,674,5268,5942
2013-03-20,1,2013,3,0,2,1,556,5250,5806
2013-03-21,2,2013,3,0,3,1,308,4200,4508
2013-03-22,2,2013,3,0,4,1,682,4725,5407
2013-03-23,2,2013,3,0,5,1,2473,4006,6479
2013-03-24,2,2013,3,0,6,0,1109,2748,3857
2013-03-25,2,2013,3,0,0,0,84,1828,1912
2013-03-26,2,2013,3,0,1,1,647,4936,5583
2013-03-27,2,2013,3,0,2,1,646,5154,5800
2013-03-28,2,2013,3,0,3,1,699,4884,5583
2013-03-29,2,2013,3,0,4,1,1968,5416,7384
2013-03-30,2,2013,3,0,5,1,5006,4592,9598
2013-03-31,2,2013,3,0,6,0,1401,2384,3785
2013-04-01,2,2013,4,0,0,0,1303,5065,6368
2013-04-02,2,2013,4,0,1,1,738,5164,5902
2013-04-03,2,2013,4,0,2,1,929,5297,6226
2013-04-04,2,2013,4,0,3,1,904,4925,5829
2013-04-05,2,2013,4,0,4,1,1559,6030,7589
2013-04-06,2,2013,4,0,5,1,4099,5172,9271
2013-04-07,2,2013,4,0,6,0,4428,5334,9762
2013-04-08,2,2013,4,0,0,0,1949,6517,8466
2013-04-09,2,2013,4,0,1,1,2138,7612,9750
2013-04-10,2,2013,4,0,2,1,1965,7588,9553
2013-04-11,2,2013,4,0,3,1,1886,7205,9091
2013-04-12,2,2013,4,0,4,1,1173,4824,5997
2013-04-13,2,2013,4,0,5,1,5375,5892,11267
2013-04-14,2,2013,4,0,6,0,4370,5234,9604
2013-04-15,2,2013,4,0,0,0,1289,5619,6908
2013-04-16,2,2013,4,0,1,1,1519,6728,8247
2013-04-17,2,2013,4,0,2,1,1363,7114,8477
2013-04-18,2,2013,4,0,3,1,1192,6494,7686
2013-04-19,2,2013,4,0,4,1,1082,5036,6118
2013-04-20,2,2013,4,0,5,1,3411,5382,8793
2013-04-21,2,2013,4,0,6,0,2510,4820,7330
2013-04-22,2,2013,4,0,0,0,779,5958,6737
2013-04-23,2,2013,4,0,1,1,946,6488,7434
2013-04-24,2,2013,4,0,2,1,1306,7154,8460
2013-04-25,2,2013,4,0,3,1,1350,6912,8262
2013-04-26,2,2013,4,0,4,1,1844,7152,8996
2013-04-27,2,2013,4,0,5,1,4947,5873,10820
2013-04-28,2,2013,4,0,6,0,3335,4516,7851
2013-04-29,2,2013,4,0,0,0,480,3809,4289
2013-04-30,2,2013,4,0,1,1,604,4755,5359
2013-05-01,2,2013,5,0,2,1,1197,7410,8607
2013-05-02,2,2013,5,0,3,1,1323,7167,8490
2013-05-03,2,2013,5,0,4,1,1774,6881,8655
2013-05-04,2,2013,5,0,5,1,3650,5822,9472
2013-05-05,2,2013,5,0,6,0,2931,5055,7986
2013-05-06,2,2013,5,0,0,0,1065,5440,6505
2013-05-07,2,2013,5,0,1,1,344,4075,4419
2013-05-08,2,2013,5,0,2,1,821,5765,6586
2013-05-09,2,2013,5,0,3,1,1122,6671,7793
2013-05-10,2,2013,5,0,4,1,1979,6891,8870
2013-05-11,2,2013,5,0,5,1,2099,4356,6455
2013-05-12,2,2013,5,0,6,0,3084,4926,8010
2013-05-13,2,2013,5,0,0,0,1064,6317,7381
2013-05-14,2,2013,5,0,1,1,1264,6797,8061
2013-05-15,2,2013,5,0,2,1,1321,7435,8756
2013-05-16,2,2013,5,0,3,1,1522,7373,8895
2013-05-17,2,2013,5,0,4,1,2544,7503,10047
2013-05-18,2,2013,5,0,5,1,1925,4408,6333
2013-05-19,2,2013,5,0,6,0,2077,4597,6674
2013-05-20,2,2013,5,0,0,0,1624,6759,8383
2013-05-21,2,2013,5,0,1,1,1648,7394,9042
2013-05-22,2,2013,5,0,2,1,1401,7494,8895
2013-05-23,2,2013,5,0,3,1,1288,6763,8051
2013-05-24,2,2013,5,0,4,1,1004,5623,6627
2013-05-25,2,2013,5,0,5,1,3621,4323,7944
2013-05-26,2,2013,5,0,6,0,5652,4236,9888
2013-05-27,2,2013,5,1,0,0,4452,4514,8966
2013-05-28,2,2013,5,0,1,1,1587,5964,7551
2013-05-29,2,2013,5,0,2,1,1736,7539,9275
2013-05-30,2,2013,5,0,3,1,1366,7374,8740
2013-05-31,2,2013,5,0,4,1,1835,7267,9102
2013-06-01,2,2013,6,0,5,1,3657,5800,9457
2013-06-02,2,2013,6,0,6,0,2997,4667,7664
2013-06-03,2,2013,6,0,0,0,1442,5951,7393
2013-06-04,2,2013,6,0,1,1,1852,8074,9926
2013-06-05,2,2013,6,0,2,1,1910,8076,9986
2013-06-06,2,2013,6,0,3,1,1223,5631,6854
2013-06-07,2,2013,6,0,4,1,242,2235,2477
2013-06-08,2,2013,6,0,5,1,3572,6186,9758
2013-06-09,2,2013,6,0,6,0,3433,5787,9220
2013-06-10,2,2013,6,0,0,0,713,3655,4368
2013-06-11,2,2013,6,0,1,1,1737,7456,9193
2013-06-12,2,2013,6,0,2,1,1585,7595,9180
2013-06-13,2,2013,6,0,3,1,1162,6097,7259
2013-06-14,2,2013,6,0,4,1,2209,7574,9783
2013-06-15,2,2013,6,0,5,1,4201,6245,10446
2013-06-16,2,2013,6,0,6,0,3533,5177,8710
2013-06-17,2,2013,6,0,0,0,1729,6884,8613
2013-06-18,2,2013,6,0,1,1,940,6200,7140
2013-06-19,2,2013,6,0,2,1,1802,8237,10039
2013-06-20,2,2013,6,0,3,1,1795,8352,10147
2013-06-21,3,2013,6,0,4,1,2367,7952,10319
2013-06-22,3,2013,6,0,5,1,4401,6398,10799
2013-06-23,3,2013,6,0,6,0,2404,4771,7175
2013-06-24,3,2013,6,0,0,0,1470,6572,8042
2013-06-25,3,2013,6,0,1,1,1559,7411,8970
2013-06-26,3,2013,6,0,2,1,1312,7080,8392
2013-06-27,3,2013,6,0,3,1,1302,7317,8619
2013-06-28,3,2013,6,0,4,1,1060,5187,6247
2013-06-29,3,2013,6,0,5,1,3973,6530,10503
2013-06-30,3,2013,6,0,6,0,2405,4682,7087
2013-07-01,3,2013,7,0,0,0,1372,6470,7842
2013-07-02,3,2013,7,0,1,1,1284,6537,7821
2013-07-03,3,2013,7,0,2,1,1603,6122,7725
2013-07-04,3,2013,7,1,3,0,5222,5520,10742
2013-07-05,3,2013,7,0,4,1,4785,5772,10557
2013-07-06,3,2013,7,0,5,1,4295,4607,8902
2013-07-07,3,2013,7,0,6,0,2490,4381,6871
2013-07-08,3,2013,7,0,0,0,1323,6747,8070
2013-07-09,3,2013,7,0,1,1,1197,7568,8765
2013-07-10,3,2013,7,0,2,1,1116,6997,8113
2013-07-11,3,2013,7,0,3,1,1385,7485,8870
2013-07-12,3,2013,7,0,4,1,1006,4719,5725
2013-07-13,3,2013,7,0,5,1,3223,6055,9278
2013-07-14,3,2013,7,0,6,0,2797,5593,8390
2013-07-15,3,2013,7,0,0,0,1343,6690,8033
2013-07-16,3,2013,7,0,1,1,1304,7098,8402
2013-07-17,3,2013,7,0,2,1,1341,7292,8633
2013-07-18,3,2013,7,0,3,1,1121,6704,7825
2013-07-19,3,2013,7,0,4,1,1512,6466,7978
2013-07-20,3,2013,7,0,5,1,3129,5494,8623
2013-07-21,3,2013,7,0,6,0,3132,5332,8464
2013-07-22,3,2013,7,0,0,0,1578,7100,8678
2013-07-23,3,2013,7,0,1,1,1513,7721,9234
2013-07-24,3,2013,7,0,2,1,1707,8053,9760
2013-07-25,3,2013,7,0,3,1,1908,8197,10105
2013-07-26,3,2013,7,0,4,1,2243,8019,10262
2013-07-27,3,2013,7,0,5,1,3173,5210,8383
2013-07-28,3,2013,7,0,6,0,2862,5276,8138
2013-07-29,3,2013,7,0,0,0,1915,7328,9243
2013-07-30,3,2013,7,0,1,1,1955,7923,9878
2013-07-31,3,2013,7,0,2,1,1468,7234,8702
2013-08-01,3,2013,8,0,3,1,1178,6577,7755
2013-08-02,3,2013,8,0,4,1,2358,7456,9814
2013-08-03,3,2013,8,0,5,1,3315,5135,8450
2013-08-04,3,2013,8,0,6,0,4317,6080,10397
2013-08-05,3,2013,8,0,0,0,2344,7709,10053
2013-08-06,3,2013,8,0,1,1,1547,6835,8382
2013-08-07,3,2013,8,0,2,1,1931,7788,9719
2013-08-08,3,2013,8,0,3,1,1538,7330,8868
2013-08-09,3,2013,8,0,4,1,2152,7309,9461
2013-08-10,3,2013,8,0,5,1,4129,5918,10047
2013-08-11,3,2013,8,0,6,0,3875,5610,9485
2013-08-12,3,2013,8,0,0,0,2154,7327,9481
2013-08-13,3,2013,8,0,1,1,1590,6713,8303
2013-08-14,3,2013,8,0,2,1,1997,8394,10391
2013-08-15,3,2013,8,0,3,1,2191,8438,10629
2013-08-16,3,2013,8,0,4,1,2794,7969,10763
2013-08-17,3,2013,8,0,5,1,4739,6303,11042
2013-08-18,3,2013,8,0,6,0,1749,4004,5753
2013-08-19,3,2013,8,0,0,0,1847,7121,8968
2013-08-20,3,2013,8,0,1,1,1725,7854,9579
2013-08-21,3,2013,8,0,2,1,1647,7493,9140
2013-08-22,3,2013,8,0,3,1,1862,7681,9543
2013-08-23,3,2013,8,0,4,1,1158,6467,7625
2013-08-24,3,2013,8,0,5,1,3782,7062,10844
2013-08-25,3,2013,8,0,6,0,3327,6154,9481
2013-08-26,3,2013,8,0,0,0,1687,7582,9269
2013-08-27,3,2013,8,0,1,1,1538,7968,9506
2013-08-28,3,2013,8,0,2,1,993,6643,7636
2013-08-29,3,2013,8,0,3,1,1646,7697,9343
2013-08-30,3,2013,8,0,4,1,2306,7355,9661
2013-08-31,3,2013,8,0,5,1,4365,5038,9403
2013-09-01,3,2013,9,0,6,0,4698,4518,9216
2013-09-02,3,2013,9,1,0,0,3201,4824,8025
2013-09-03,3,2013,9,0,1,1,1375,7435,8810
2013-09-04,3,2013,9,0,2,1,1532,8202,9734
2013-09-05,3,2013,9,0,3,1,1575,8343,9918
2013-09-06,3,2013,9,0,4,1,1814,8327,10141
2013-09-07,3,2013,9,0,5,1,3211,6907,10118
2013-09-08,3,2013,9,0,6,0,3033,6367,9400
2013-09-09,3,2013,9,0,0,0,1381,7675,9056
2013-09-10,3,2013,9,0,1,1,1435,7995,9430
2013-09-11,3,2013,9,0,2,1,1271,7904,9175
2013-09-12,3,2013,9,0,3,1,946,6035,6981
2013-09-13,3,2013,9,0,4,1,1589,8342,9931
2013-09-14,3,2013,9,0,5,1,3943,7188,11131
2013-09-15,3,2013,9,0,6,0,3201,6547,9748
2013-09-16,3,2013,9,0,0,0,1084,7184,8268
2013-09-17,3,2013,9,0,1,1,1269,8567,9836
2013-09-18,3,2013,9,0,2,1,1298,8654,9952
2013-09-19,3,2013,9,0,3,1,1637,8723,10360
2013-09-20,3,2013,9,0,4,1,1909,8636,10545
2013-09-21,3,2013,9,0,5,1,2149,4691,6840
2013-09-22,3,2013,9,0,6,0,2749,6590,9339
2013-09-23,4,2013,9,0,0,0,1272,7709,8981
2013-09-24,4,2013,9,0,1,1,1144,8345,9489
2013-09-25,4,2013,9,0,2,1,1169,8355,9524
2013-09-26,4,2013,9,0,3,1,1293,8495,9788
2013-09-27,4,2013,9,0,4,1,1634,8224,9858
2013-09-28,4,2013,9,0,5,1,3502,6555,10057
2013-09-29,4,2013,9,0,6,0,3080,6171,9251
2013-09-30,4,2013,9,0,0,0,1338,7694,9032
2013-10-01,4,2013,10,0,1,1,1339,8916,10255
2013-10-02,4,2013,10,0,2,1,1289,8960,10249
2013-10-03,4,2013,10,0,3,1,1248,8811,10059
2013-10-04,4,2013,10,0,4,1,1667,8491,10158
2013-10-05,4,2013,10,0,5,1,3401,7055,10456
2013-10-06,4,2013,10,0,6,0,2992,6658,9650
2013-10-07,4,2013,10,0,0,0,420,5377,5797
2013-10-08,4,2013,10,0,1,1,1278,8551,9829
2013-10-09,4,2013,10,0,2,1,757,5603,6360
2013-10-10,4,2013,10,0,3,1,180,2311,2491
2013-10-11,4,2013,10,0,4,1,117,1658,1775
2013-10-12,4,2013,10,0,5,1,1299,3892,5191
2013-10-13,4,2013,10,0,6,0,1523,4415,5938
2013-10-14,4,2013,10,1,0,0,1830,6988,8818
2013-10-15,4,2013,10,0,1,1,1031,8241,9272
2013-10-16,4,2013,10,0,2,1,1113,8516,9629
2013-10-17,4,2013,10,0,3,1,1049,8419,9468
2013-10-18,4,2013,10,0,4,1,1870,8386,10256
2013-10-19,4,2013,10,0,5,1,3190,6119,9309
2013-10-20,4,2013,10,0,6,0,2541,5952,8493
2013-10-21,4,2013,10,0,0,0,1331,7625,8956
2013-10-22,4,2013,10,0,1,1,736,8254,8990
2013-10-23,4,2013,10,0,2,1,616,7268,7884
2013-10-24,4,2013,10,0,3,1,591,7232,7823
2013-10-25,4,2013,10,0,4,1,913,6953,7866
2013-10-26,4,2013,10,0,5,1,2195,5711,7906
2013-10-27,4,2013,10,0,6,0,2380,5537,7917
2013-10-28,4,2013,10,0,0,0,1177,7338,8515
2013-10-29,4,2013,10,0,1,1,963,7986,8949
2013-10-30,4,2013,10,0,2,1,806,7249,8055
2013-10-31,4,2013,10,0,3,1,723,7612,8335
2013-11-01,4,2013,11,0,4,1,921,7125,8046
2013-11-02,4,2013,11,0,5,1,2866,6507,9373
2013-11-03,4,2013,11,0,6,0,2115,5537,7652
2013-11-04,4,2013,11,0,0,0,554,6300,6854
2013-11-05,4,2013,11,0,1,1,670,7482,8152
2013-11-06,4,2013,11,0,2,1,797,7982,8779
2013-11-07,4,2013,11,0,3,1,485,7489,7974
2013-11-08,4,2013,11,0,4,1,727,6781,7508
2013-11-09,4,2013,11,0,5,1,2191,5350,7541
2013-11-10,4,2013,11,0,6,0,2067,5110,7177
2013-11-11,4,2013,11,1,0,0,972,6216,7188
2013-11-12,4,2013,11,0,1,1,262,5850,6112
2013-11-13,4,2013,11,0,2,1,280,6186,6466
2013-11-14,4,2013,11,0,3,1,378,6895,7273
2013-11-15,4,2013,11,0,4,1,782,6889,7671
2013-11-16,4,2013,11,0,5,1,1529,5275,6804
2013-11-17,4,2013,11,0,6,0,1446,5499,6945
2013-11-18,4,2013,11,0,0,0,707,7546,8253
2013-11-19,4,2013,11,0,1,1,426,7019,7445
2013-11-20,4,2013,11,0,2,1,452,6888,7340
2013-11-21,4,2013,11,0,3,1,471,7050,7521
2013-11-22,4,2013,11,0,4,1,719,7427,8146
2013-11-23,4,2013,11,0,5,1,1267,4867,6134
2013-11-24,4,2013,11,0,6,0,370,2823,3193
2013-11-25,4,2013,11,0,0,0,310,4950,5260
2013-11-26,4,2013,11,0,1,1,51,1822,1873
2013-11-27,4,2013,11,0,2,1,44,2196,2240
2013-11-28,4,2013,11,1,3,0,388,1186,1574
2013-11-29,4,2013,11,0,4,1,722,2196,2918
2013-11-30,4,2013,11,0,5,1,784,2219,3003
2013-12-01,4,2013,12,0,6,0,662,3008,3670
2013-12-02,4,2013,12,0,0,0,284,6030,6314
2013-12-03,4,2013,12,0,1,1,416,7032,7448
2013-12-04,4,2013,12,0,2,1,437,7114,7551
2013-12-05,4,2013,12,0,3,1,582,7560,8142
2013-12-06,4,2013,12,0,4,1,145,2799,2944
2013-12-07,4,2013,12,0,5,1,593,4285,4878
2013-12-08,4,2013,12,0,6,0,88,1269,1357
2013-12-09,4,2013,12,0,0,0,67,3379,3446
2013-12-10,4,2013,12,0,1,1,99,2597,2696
2013-12-11,4,2013,12,0,2,1,224,5246,5470
2013-12-12,4,2013,12,0,3,1,158,4926,5084
2013-12-13,4,2013,12,0,4,1,246,5378,5624
2013-12-14,4,2013,12,0,5,1,253,2541,2794
2013-12-15,4,2013,12,0,6,0,539,3762,4301
2013-12-16,4,2013,12,0,0,0,239,5373,5612
2013-12-17,4,2013,12,0,1,1,202,5148,5350
2013-12-18,4,2013,12,0,2,1,292,5480,5772
2013-12-19,4,2013,12,0,3,1,481,6172,6653
2013-12-20,4,2013,12,0,4,1,580,5931,6511
2013-12-21,1,2013,12,0,5,1,1838,4592,6430
2013-12-22,1,2013,12,0,6,0,660,2170,2830
2013-12-23,1,2013,12,0,0,0,159,1843,2002
2013-12-24,1,2013,12,0,1,1,276,2069,2345
2013-12-25,1,2013,12,1,2,0,354,647,1001
2013-12-26,1,2013,12,0,3,1,425,2021,2446
2013-12-27,1,2013,12,0,4,1,800,2784,3584
2013-12-28,1,2013,12,0,5,1,1936,2485,4421
2013-12-29,1,2013,12,0,6,0,287,1154,1441
2013-12-30,1,2013,12,0,0,0,674,3682,4356
2013-12-31,1,2013,12,0,1,1,531,3595,4126
2014-01-01,1,2014,1,1,2,0,730,2281,3011
2014-01-02,1,2014,1,0,3,1,288,3028,3316
2014-01-03,1,2014,1,0,4,1,75,1533,1608
2014-01-04,1,2014,1,0,5,1,158,2084,2242
2014-01-05,1,2014,1,0,6,0,135,1925,2060
2014-01-06,1,2014,1,0,0,0,123,3384,3507
2014-01-07,1,2014,1,0,1,1,29,2253,2282
2014-01-08,1,2014,1,0,2,1,75,3780,3855
2014-01-09,1,2014,1,0,3,1,190,4758,4948
2014-01-10,1,2014,1,0,4,1,81,1762,1843
2014-01-11,1,2014,1,0,5,1,97,1858,1955
2014-01-12,1,2014,1,0,6,0,999,4414,5413
2014-01-13,1,2014,1,0,0,0,732,6129,6861
2014-01-14,1,2014,1,0,1,1,345,4714,5059
2014-01-15,1,2014,1,0,2,1,516,5943,6459
2014-01-16,1,2014,1,0,3,1,385,5631,6016
2014-01-17,1,2014,1,0,4,1,532,5606,6138
2014-01-18,1,2014,1,0,5,1,410,2889,3299
2014-01-19,1,2014,1,0,6,0,720,3379,4099
2014-01-20,1,2014,1,1,0,0,880,4436,5316
2014-01-21,1,2014,1,0,1,1,45,1702,1747
2014-01-22,1,2014,1,0,2,1,13,1413,1426
2014-01-23,1,2014,1,0,3,1,34,2392,2426
2014-01-24,1,2014,1,0,4,1,40,2583,2623
2014-01-25,1,2014,1,0,5,1,93,2166,2259
2014-01-26,1,2014,1,0,6,0,130,2424,2554
2014-01-27,1,2014,1,0,0,0,69,4415,4484
2014-01-28,1,2014,1,0,1,1,39,3090,3129
2014-01-29,1,2014,1,0,2,1,58,3102,3160
2014-01-30,1,2014,1,0,3,1,68,4110,4178
2014-01-31,1,2014,1,0,4,1,239,5185,5424
2014-02-01,1,2014,2,0,5,1,767,4575,5342
2014-02-02,1,2014,2,0,6,0,836,4587,5423
2014-02-03,1,2014,2,0,0,0,61,2401,2462
2014-02-04,1,2014,2,0,1,1,130,5047,5177
2014-02-05,1,2014,2,0,2,1,116,3630,3746
2014-02-06,1,2014,2,0,3,1,150,5026,5176
2014-02-07,1,2014,2,0,4,1,220,5174,5394
2014-02-08,1,2014,2,0,5,1,390,3647,4037
2014-02-09,1,2014,2,0,6,0,212,2908,3120
2014-02-10,1,2014,2,0,0,0,127,4304,4431
2014-02-11,1,2014,2,0,1,1,181,4566,4747
2014-02-12,1,2014,2,0,2,1,84,3861,3945
2014-02-13,1,2014,2,0,3,1,3,49,52
2014-02-14,1,2014,2,0,4,1,73,1838,1911
2014-02-15,1,2014,2,0,5,1,139,1609,1748
2014-02-16,1,2014,2,0,6,0,384,2454,2838
2014-02-17,1,2014,2,1,0,0,330,2981,3311
2014-02-18,1,2014,2,0,1,1,269,4817,5086
2014-02-19,1,2014,2,0,2,1,244,5378,5622
2014-02-20,1,2014,2,0,3,1,429,6148,6577
2014-02-21,1,2014,2,0,4,1,346,5437,5783
2014-02-22,1,2014,2,0,5,1,1953,5864,7817
2014-02-23,1,2014,2,0,6,0,841,5224,6065
2014-02-24,1,2014,2,0,0,0,295,5101,5396
2014-02-25,1,2014,2,0,1,1,157,4404,4561
2014-02-26,1,2014,2,0,2,1,102,3819,3921
2014-02-27,1,2014,2,0,3,1,159,4723,4882
2014-02-28,1,2014,2,0,4,1,173,3920,4093
2014-03-01,1,2014,3,0,5,1,806,3754,4560
2014-03-02,1,2014,3,0,6,0,540,2953,3493
2014-03-03,1,2014,3,0,0,0,16,402,418
2014-03-04,1,2014,3,0,1,1,62,2182,2244
2014-03-05,1,2014,3,0,2,1,237,4275,4512
2014-03-06,1,2014,3,0,3,1,240,4592,4832
2014-03-07,1,2014,3,0,4,1,256,4808,5064
2014-03-08,1,2014,3,0,5,1,2810,5606,8416
2014-03-09,1,2014,3,0,6,0,1488,4428,5916
2014-03-10,1,2014,3,0,0,0,844,5941,6785
2014-03-11,1,2014,3,0,1,1,1306,7054,8360
2014-03-12,1,2014,3,0,2,1,702,5527,6229
2014-03-13,1,2014,3,0,3,1,212,3772,3984
2014-03-14,1,2014,3,0,4,1,1119,5830,6949
2014-03-15,1,2014,3,0,5,1,3753,6591,10344
2014-03-16,1,2014,3,0,6,0,1262,3551,4813
2014-03-17,1,2014,3,0,0,0,61,1218,1279
2014-03-18,1,2014,3,0,1,1,219,4439,4658
2014-03-19,1,2014,3,0,2,1,112,3642,3754
2014-03-20,1,2014,3,0,3,1,797,6717,7514
2014-03-21,2,2014,3,0,4,1,1007,6670,7677
2014-03-22,2,2014,3,0,5,1,4709,6138,10847
2014-03-23,2,2014,3,0,6,0,1184,4129,5313
2014-03-24,2,2014,3,0,0,0,519,4822,5341
2014-03-25,2,2014,3,0,1,1,105,2987,3092
2014-03-26,2,2014,3,0,2,1,248,4685,4933
2014-03-27,2,2014,3,0,3,1,621,5828,6449
2014-03-28,2,2014,3,0,4,1,896,5774,6670
2014-03-29,2,2014,3,0,5,1,287,1975,2262
2014-03-30,2,2014,3,0,6,0,58,838,896
2014-03-31,2,2014,3,0,0,0,1392,6766,8158
2014-04-01,2,2014,4,0,1,1,1507,7864,9371
2014-04-02,2,2014,4,0,2,1,1328,7558,8886
2014-04-03,2,2014,4,0,3,1,1432,7675,9107
2014-04-04,2,2014,4,0,4,1,1505,7372,8877
2014-04-05,2,2014,4,0,5,1,4624,6130,10754
2014-04-06,2,2014,4,0,6,0,3676,6141,9817
2014-04-07,2,2014,4,0,0,0,148,2653,2801
2014-04-08,2,2014,4,0,1,1,1097,7752,8849
2014-04-09,2,2014,4,0,2,1,1484,8388,9872
2014-04-10,2,2014,4,0,3,1,2347,8894,11241
2014-04-11,2,2014,4,0,4,1,2982,8450,11432
2014-04-12,2,2014,4,0,5,1,7918,7646,15564
2014-04-13,2,2014,4,0,6,0,7450,6969,14419
2014-04-14,2,2014,4,0,0,0,3082,7492,10574
2014-04-15,2,2014,4,0,1,1,190,1626,1816
2014-04-16,2,2014,4,0,2,1,1356,6415,7771
2014-04-17,2,2014,4,0,3,1,1515,7109,8624
2014-04-18,2,2014,4,0,4,1,2323,7018,9341
2014-04-19,2,2014,4,0,5,1,5910,6016,11926
2014-04-20,2,2014,4,0,6,0,4095,5418,9513
2014-04-21,2,2014,4,0,0,0,2029,7641,9670
2014-04-22,2,2014,4,0,1,1,1263,7845,9108
2014-04-23,2,2014,4,0,2,1,1201,7724,8925
2014-04-24,2,2014,4,0,3,1,1608,8196,9804
2014-04-25,2,2014,4,0,4,1,1548,6026,7574
2014-04-26,2,2014,4,0,5,1,4959,6551,11510
2014-04-27,2,2014,4,0,6,0,4496,6545,11041
2014-04-28,2,2014,4,0,0,0,1253,5162,6415
2014-04-29,2,2014,4,0,1,1,208,2907,3115
2014-04-30,2,2014,4,0,2,1,57,1736,1793
2014-05-01,2,2014,5,0,3,1,1272,8306,9578
2014-05-02,2,2014,5,0,4,1,1880,8453,10333
2014-05-03,2,2014,5,0,5,1,4209,6973,11182
2014-05-04,2,2014,5,0,6,0,3810,6702,10512
2014-05-05,2,2014,5,0,0,0,1398,6689,8087
2014-05-06,2,2014,5,0,1,1,1744,8659,10403
2014-05-07,2,2014,5,0,2,1,929,7633,8562
2014-05-08,2,2014,5,0,3,1,1559,8844,10403
2014-05-09,2,2014,5,0,4,1,2007,8402,10409
2014-05-10,2,2014,5,0,5,1,2588,5643,8231
2014-05-11,2,2014,5,0,6,0,4122,6847,10969
2014-05-12,2,2014,5,0,0,0,1736,7698,9434
2014-05-13,2,2014,5,0,1,1,1659,8271,9930
2014-05-14,2,2014,5,0,2,1,1533,8188,9721
2014-05-15,2,2014,5,0,3,1,1517,7883,9400
2014-05-16,2,2014,5,0,4,1,1548,6485,8033
2014-05-17,2,2014,5,0,5,1,4251,6952,11203
2014-05-18,2,2014,5,0,6,0,3609,6598,10207
2014-05-19,2,2014,5,0,0,0,2139,8294,10433
2014-05-20,2,2014,5,0,1,1,2067,8780,10847
2014-05-21,2,2014,5,0,2,1,1301,7202,8503
2014-05-22,2,2014,5,0,3,1,1845,8481,10326
2014-05-23,2,2014,5,0,4,1,2177,8222,10399
2014-05-24,2,2014,5,0,5,1,5142,5383,10525
2014-05-25,2,2014,5,0,6,0,6742,5343,12085
2014-05-26,2,2014,5,1,0,0,5030,5659,10689
2014-05-27,2,2014,5,0,1,1,1632,6589,8221
2014-05-28,2,2014,5,0,2,1,1497,8425,9922
2014-05-29,2,2014,5,0,3,1,548,4759,5307
2014-05-30,2,2014,5,0,4,1,2014,8791,10805
2014-05-31,2,2014,5,0,5,1,4526,7548,12074
2014-06-01,2,2014,6,0,6,0,3785,7147,10932
2014-06-02,2,2014,6,0,0,0,1863,8492,10355
2014-06-03,2,2014,6,0,1,1,1617,8750,10367
2014-06-04,2,2014,6,0,2,1,1509,8657,10166
2014-06-05,2,2014,6,0,3,1,1518,9219,10737
2014-06-06,2,2014,6,0,4,1,2183,9626,11809
2014-06-07,2,2014,6,0,5,1,4275,7565,11840
2014-06-08,2,2014,6,0,6,0,3843,6745,10588
2014-06-09,2,2014,6,0,0,0,2004,8492,10496
2014-06-10,2,2014,6,0,1,1,1470,8078,9548
2014-06-11,2,2014,6,0,2,1,1213,7399,8612
2014-06-12,2,2014,6,0,3,1,1167,8043,9210
2014-06-13,2,2014,6,0,4,1,1522,7935,9457
2014-06-14,2,2014,6,0,5,1,4318,7576,11894
2014-06-15,2,2014,6,0,6,0,3981,7055,11036
2014-06-16,2,2014,6,0,0,0,1923,8509,10432
2014-06-17,2,2014,6,0,1,1,1723,8783,10506
2014-06-18,2,2014,6,0,2,1,1536,8455,9991
2014-06-19,2,2014,6,0,3,1,1717,8707,10424
2014-06-20,2,2014,6,0,4,1,2443,9191,11634
2014-06-21,3,2014,6,0,5,1,3639,6167,9806
2014-06-22,3,2014,6,0,6,0,3812,7016,10828
2014-06-23,3,2014,6,0,0,0,2214,8624,10838
2014-06-24,3,2014,6,0,1,1,1958,9211,11169
2014-06-25,3,2014,6,0,2,1,1705,8490,10195
2014-06-26,3,2014,6,0,3,1,1737,9228,10965
2014-06-27,3,2014,6,0,4,1,2274,8365,10639
2014-06-28,3,2014,6,0,5,1,3934,6916,10850
2014-06-29,3,2014,6,0,6,0,4119,6659,10778
2014-06-30,3,2014,6,0,0,0,2069,8402,10471
2014-07-01,3,2014,7,0,1,1,1898,8604,10502
2014-07-02,3,2014,7,0,2,1,1691,7874,9565
2014-07-03,3,2014,7,0,3,1,1925,6673,8598
2014-07-04,3,2014,7,1,4,0,5997,5900,11897
2014-07-05,3,2014,7,0,5,1,7096,5730,12826
2014-07-06,3,2014,7,0,6,0,4972,5954,10926
2014-07-07,3,2014,7,0,0,0,2111,7942,10053
2014-07-08,3,2014,7,0,1,1,1383,7160,8543
2014-07-09,3,2014,7,0,2,1,1516,7283,8799
2014-07-10,3,2014,7,0,3,1,1543,7146,8689
2014-07-11,3,2014,7,0,4,1,2546,8683,11229
2014-07-12,3,2014,7,0,5,1,4894,6618,11512
2014-07-13,3,2014,7,0,6,0,3471,5870,9341
2014-07-14,3,2014,7,0,0,0,1885,6654,8539
2014-07-15,3,2014,7,0,1,1,1374,6478,7852
2014-07-16,3,2014,7,0,2,1,2282,9026,11308
2014-07-17,3,2014,7,0,3,1,2589,9021,11610
2014-07-18,3,2014,7,0,4,1,3126,8531,11657
2014-07-19,3,2014,7,0,5,1,5247,6517,11764
2014-07-20,3,2014,7,0,6,0,4664,6141,10805
2014-07-21,3,2014,7,0,0,0,2852,8177,11029
2014-07-22,3,2014,7,0,1,1,2612,8580,11192
2014-07-23,3,2014,7,0,2,1,2191,8030,10221
2014-07-24,3,2014,7,0,3,1,2398,8292,10690
2014-07-25,3,2014,7,0,4,1,3619,8692,12311
2014-07-26,3,2014,7,0,5,1,5559,6424,11983
2014-07-27,3,2014,7,0,6,0,4158,5847,10005
2014-07-28,3,2014,7,0,0,0,2621,8067,10688
2014-07-29,3,2014,7,0,1,1,2570,8788,11358
2014-07-30,3,2014,7,0,2,1,2477,8882,11359
2014-07-31,3,2014,7,0,3,1,2496,8486,10982
2014-08-01,3,2014,8,0,4,1,2210,7641,9851
2014-08-02,3,2014,8,0,5,1,5216,5621,10837
2014-08-03,3,2014,8,0,6,0,3925,5899,9824
2014-08-04,3,2014,8,0,0,0,2939,7948,10887
2014-08-05,3,2014,8,0,1,1,2546,8170,10716
2014-08-06,3,2014,8,0,2,1,2603,8348,10951
2014-08-07,3,2014,8,0,3,1,2579,8484,11063
2014-08-08,3,2014,8,0,4,1,3326,7948,11274
2014-08-09,3,2014,8,0,5,1,4724,5632,10356
2014-08-10,3,2014,8,0,6,0,4958,5721,10679
2014-08-11,3,2014,8,0,0,0,2776,6836,9612
2014-08-12,3,2014,8,0,1,1,880,5090,5970
2014-08-13,3,2014,8,0,2,1,2532,8350,10882
2014-08-14,3,2014,8,0,3,1,2660,8346,11006
2014-08-15,3,2014,8,0,4,1,3481,8461,11942
2014-08-16,3,2014,8,0,5,1,5827,6424,12251
2014-08-17,3,2014,8,0,6,0,4385,6203,10588
2014-08-18,3,2014,8,0,0,0,2514,8200,10714
2014-08-19,3,2014,8,0,1,1,1865,8665,10530
2014-08-20,3,2014,8,0,2,1,1928,7222,9150
2014-08-21,3,2014,8,0,3,1,2019,7716,9735
2014-08-22,3,2014,8,0,4,1,2205,8039,10244
2014-08-23,3,2014,8,0,5,1,2045,4386,6431
2014-08-24,3,2014,8,0,6,0,3841,6951,10792
2014-08-25,3,2014,8,0,0,0,2145,8599,10744
2014-08-26,3,2014,8,0,1,1,1921,8953,10874
2014-08-27,3,2014,8,0,2,1,2078,9060,11138
2014-08-28,3,2014,8,0,3,1,2016,9045,11061
2014-08-29,3,2014,8,0,4,1,2847,8765,11612
2014-08-30,3,2014,8,0,5,1,4945,5269,10214
2014-08-31,3,2014,8,0,6,0,4547,4393,8940
2014-09-01,3,2014,9,1,0,0,3306,4997,8303
2014-09-02,3,2014,9,0,1,1,1403,7220,8623
2014-09-03,3,2014,9,0,2,1,1417,8995,10412
2014-09-04,3,2014,9,0,3,1,1561,9269,10830
2014-09-05,3,2014,9,0,4,1,1859,9147,11006
2014-09-06,3,2014,9,0,5,1,2781,6534,9315
2014-09-07,3,2014,9,0,6,0,3622,7607,11229
2014-09-08,3,2014,9,0,0,0,1728,8649,10377
2014-09-09,3,2014,9,0,1,1,1471,9507,10978
2014-09-10,3,2014,9,0,2,1,1403,9830,11233
2014-09-11,3,2014,9,0,3,1,1325,9672,10997
2014-09-12,3,2014,9,0,4,1,2193,9986,12179
2014-09-13,3,2014,9,0,5,1,2147,6060,8207
2014-09-14,3,2014,9,0,6,0,4086,7825,11911
2014-09-15,3,2014,9,0,0,0,1861,9487,11348
2014-09-16,3,2014,9,0,1,1,1905,10229,12134
2014-09-17,3,2014,9,0,2,1,1693,9940,11633
2014-09-18,3,2014,9,0,3,1,1447,10060,11507
2014-09-19,3,2014,9,0,4,1,2019,9836,11855
2014-09-20,3,2014,9,0,5,1,4472,8205,12677
2014-09-21,3,2014,9,0,6,0,3421,7316,10737
2014-09-22,3,2014,9,0,0,0,1563,9439,11002
2014-09-23,4,2014,9,0,1,1,1367,10225,11592
2014-09-24,4,2014,9,0,2,1,1112,8197,9309
2014-09-25,4,2014,9,0,3,1,518,6127,6645
2014-09-26,4,2014,9,0,4,1,2251,9880,12131
2014-09-27,4,2014,9,0,5,1,4422,8204,12626
2014-09-28,4,2014,9,0,6,0,3605,7299,10904
2014-09-29,4,2014,9,0,0,0,1587,9040,10627
2014-09-30,4,2014,9,0,1,1,1416,10192,11608
2014-10-01,4,2014,10,0,2,1,1229,9321,10550
2014-10-02,4,2014,10,0,3,1,1504,10192,11696
2014-10-03,4,2014,10,0,4,1,1688,9215,10903
2014-10-04,4,2014,10,0,5,1,3370,7272,10642
2014-10-05,4,2014,10,0,6,0,2809,6838,9647
2014-10-06,4,2014,10,0,0,0,1655,9000,10655
2014-10-07,4,2014,10,0,1,1,1122,8342,9464
2014-10-08,4,2014,10,0,2,1,1435,9826,11261
2014-10-09,4,2014,10,0,3,1,1614,9616,11230
2014-10-10,4,2014,10,0,4,1,1304,6840,8144
2014-10-11,4,2014,10,0,5,1,1572,4125,5697
2014-10-12,4,2014,10,0,6,0,3492,5927,9419
2014-10-13,4,2014,10,1,0,0,1080,5531,6611
2014-10-14,4,2014,10,0,1,1,1560,9340,10900
2014-10-15,4,2014,10,0,2,1,444,5656,6100
2014-10-16,4,2014,10,0,3,1,1180,8896,10076
2014-10-17,4,2014,10,0,4,1,2659,9281,11940
2014-10-18,4,2014,10,0,5,1,3938,6910,10848
2014-10-19,4,2014,10,0,6,0,2273,5848,8121
2014-10-20,4,2014,10,0,0,0,1202,8224,9426
2014-10-21,4,2014,10,0,1,1,745,6722,7467
2014-10-22,4,2014,10,0,2,1,240,4146,4386
2014-10-23,4,2014,10,0,3,1,1055,8699,9754
2014-10-24,4,2014,10,0,4,1,1716,8737,10453
2014-10-25,4,2014,10,0,5,1,3828,7354,11182
2014-10-26,4,2014,10,0,6,0,3307,6946,10253
2014-10-27,4,2014,10,0,0,0,1577,8961,10538
2014-10-28,4,2014,10,0,1,1,1419,10163,11582
2014-10-29,4,2014,10,0,2,1,771,8625,9396
2014-10-30,4,2014,10,0,3,1,887,9158,10045
2014-10-31,4,2014,10,0,4,1,1131,8444,9575
2014-11-01,4,2014,11,0,5,1,1128,4936,6064
2014-11-02,4,2014,11,0,6,0,894,4749,5643
2014-11-03,4,2014,11,0,0,0,619,7944,8563
2014-11-04,4,2014,11,0,1,1,750,9059,9809
2014-11-05,4,2014,11,0,2,1,700,8418,9118
2014-11-06,4,2014,11,0,3,1,422,6884,7306
2014-11-07,4,2014,11,0,4,1,846,7844,8690
2014-11-08,4,2014,11,0,5,1,1772,5779,7551
2014-11-09,4,2014,11,0,6,0,2002,5824,7826
2014-11-10,4,2014,11,0,0,0,1175,8119,9294
2014-11-11,4,2014,11,1,1,0,1720,9052,10772
2014-11-12,4,2014,11,0,2,1,779,8760,9539
2014-11-13,4,2014,11,0,3,1,485,6639,7124
2014-11-14,4,2014,11,0,4,1,479,6539,7018
2014-11-15,4,2014,11,0,5,1,1217,4721,5938
2014-11-16,4,2014,11,0,6,0,862,3875,4737
2014-11-17,4,2014,11,0,0,0,169,3914,4083
2014-11-18,4,2014,11,0,1,1,271,5257,5528
2014-11-19,4,2014,11,0,2,1,194,5788,5982
2014-11-20,4,2014,11,0,3,1,311,6923,7234
2014-11-21,4,2014,11,0,4,1,413,5932,6345
2014-11-22,4,2014,11,0,5,1,908,4653,5561
2014-11-23,4,2014,11,0,6,0,1107,4453,5560
2014-11-24,4,2014,11,0,0,0,1070,8072,9142
2014-11-25,4,2014,11,0,1,1,888,7239,8127
2014-11-26,4,2014,11,0,2,1,53,1371,1424
2014-11-27,4,2014,11,1,3,0,431,1412,1843
2014-11-28,4,2014,11,0,4,1,520,2089,2609
2014-11-29,4,2014,11,0,5,1,1010,2641,3651
2014-11-30,4,2014,11,0,6,0,973,3993,4966
2014-12-01,4,2014,12,0,0,0,460,5854,6314
2014-12-02,4,2014,12,0,1,1,57,2596,2653
2014-12-03,4,2014,12,0,2,1,223,6630,6853
2014-12-04,4,2014,12,0,3,1,346,6986,7332
2014-12-05,4,2014,12,0,4,1,279,5707,5986
2014-12-06,4,2014,12,0,5,1,287,2390,2677
2014-12-07,4,2014,12,0,6,0,703,4550,5253
2014-12-08,4,2014,12,0,0,0,263,5763,6026
2014-12-09,4,2014,12,0,1,1,75,3215,3290
2014-12-10,4,2014,12,0,2,1,261,6436,6697
2014-12-11,4,2014,12,0,3,1,293,6027,6320
2014-12-12,4,2014,12,0,4,1,446,6314,6760
2014-12-13,4,2014,12,0,5,1,738,4885,5623
2014-12-14,4,2014,12,0,6,0,754,4493,5247
2014-12-15,4,2014,12,0,0,0,554,7084,7638
2014-12-16,4,2014,12,0,1,1,212,5735,5947
2014-12-17,4,2014,12,0,2,1,495,6874,7369
2014-12-18,4,2014,12,0,3,1,241,6072,6313
2014-12-19,4,2014,12,0,4,1,308,5559,5867
2014-12-20,4,2014,12,0,5,1,442,3405,3847
2014-12-21,1,2014,12,0,6,0,622,2930,3552
2014-12-22,1,2014,12,0,0,0,155,2808,2963
2014-12-23,1,2014,12,0,1,1,224,3496,3720
2014-12-24,1,2014,12,0,2,1,57,1155,1212
2014-12-25,1,2014,12,1,3,0,779,856,1635
2014-12-26,1,2014,12,0,4,1,1170,1741,2911
2014-12-27,1,2014,12,0,5,1,2151,2030,4181
2014-12-28,1,2014,12,0,6,0,1126,1735,2861
2014-12-29,1,2014,12,0,0,0,1175,3967,5142
2014-12-30,1,2014,12,0,1,1,801,4361,5162
2014-12-31,1,2014,12,0,2,1,549,3660,4209
2015-01-01,1,2015,1,1,3,0,559,2019,2578
2015-01-02,1,2015,1,0,4,1,938,4170,5108
2015-01-03,1,2015,1,0,5,1,217,1486,1703
2015-01-04,1,2015,1,0,6,0,502,3156,3658
2015-01-05,1,2015,1,0,0,0,293,4929,5222
2015-01-06,1,2015,1,0,1,1,45,2015,2060
2015-01-07,1,2015,1,0,2,1,65,2970,3035
2015-01-08,1,2015,1,0,3,1,40,2912,2952
2015-01-09,1,2015,1,0,4,1,87,4127,4214
2015-01-10,1,2015,1,0,5,1,159,2514,2673
2015-01-11,1,2015,1,0,6,0,363,3088,3451
2015-01-12,1,2015,1,0,0,0,83,2072,2155
2015-01-13,1,2015,1,0,1,1,246,5227,5473
2015-01-14,1,2015,1,0,2,1,205,4350,4555
2015-01-15,1,2015,1,0,3,1,272,5502,5774
2015-01-16,1,2015,1,0,4,1,263,5420,5683
2015-01-17,1,2015,1,0,5,1,693,3524,4217
2015-01-18,1,2015,1,0,6,0,277,2246,2523
2015-01-19,1,2015,1,1,0,0,618,4016,4634
2015-01-20,1,2015,1,0,1,1,202,6061,6263
2015-01-21,1,2015,1,0,2,1,121,5229,5350
2015-01-22,1,2015,1,0,3,1,309,6060,6369
2015-01-23,1,2015,1,0,4,1,268,4465,4733
2015-01-24,1,2015,1,0,5,1,231,3241,3472
2015-01-25,1,2015,1,0,6,0,657,4502,5159
2015-01-26,1,2015,1,0,0,0,34,2395,2429
2015-01-27,1,2015,1,0,1,1,72,3995,4067
2015-01-28,1,2015,1,0,2,1,103,4991,5094
2015-01-29,1,2015,1,0,3,1,95,4533,4628
2015-01-30,1,2015,1,0,4,1,131,4717,4848
2015-01-31,1,2015,1,0,5,1,321,3010,3331
2015-02-01,1,2015,2,0,6,0,269,3318,3587
2015-02-02,1,2015,2,0,0,0,54,3827,3881
2015-02-03,1,2015,2,0,1,1,6,5111,5117
2015-02-04,1,2015,2,0,2,1,39,6035,6074
2015-02-05,1,2015,2,0,3,1,153,4833,4986
2015-02-06,1,2015,2,0,4,1,176,4751,4927
2015-02-07,1,2015,2,0,5,1,737,4188,4925
2015-02-08,1,2015,2,0,6,0,1554,5093,6647
2015-02-09,1,2015,2,0,0,0,164,4775,4939
2015-02-10,1,2015,2,0,1,1,204,5463,5667
2015-02-11,1,2015,2,0,2,1,416,6176,6592
2015-02-12,1,2015,2,0,3,1,223,5216,5439
2015-02-13,1,2015,2,0,4,1,165,3845,4010
2015-02-14,1,2015,2,0,5,1,481,2452,2933
2015-02-15,1,2015,2,0,6,0,71,970,1041
2015-02-16,1,2015,2,1,0,0,96,1219,1315
2015-02-17,1,2015,2,0,1,1,35,1143,1178
2015-02-18,1,2015,2,0,2,1,43,3100,3143
2015-02-19,1,2015,2,0,3,1,57,2625,2682
2015-02-20,1,2015,2,0,4,1,61,2423,2484
2015-02-21,1,2015,2,0,5,1,22,719,741
2015-02-22,1,2015,2,0,6,0,141,1848,1989
2015-02-23,1,2015,2,0,0,0,79,3518,3597
2015-02-24,1,2015,2,0,1,1,59,3812,3871
2015-02-25,1,2015,2,0,2,1,118,4832,4950
2015-02-26,1,2015,2,0,3,1,103,3372,3475
2015-02-27,1,2015,2,0,4,1,186,4454,4640
2015-02-28,1,2015,2,0,5,1,396,2826,3222
2015-03-01,1,2015,3,0,6,0,48,720,768
2015-03-02,1,2015,3,0,0,0,170,3897,4067
2015-03-03,1,2015,3,0,1,1,155,3676,3831
2015-03-04,1,2015,3,0,2,1,112,4029,4141
2015-03-05,1,2015,3,0,3,1,29,509,538
2015-03-06,1,2015,3,0,4,1,73,1855,1928
2015-03-07,1,2015,3,0,5,1,352,2830,3182
2015-03-08,1,2015,3,0,6,0,1273,4075,5348
2015-03-09,1,2015,3,0,0,0,1301,6641,7942
2015-03-10,1,2015,3,0,1,1,362,3579,3941
2015-03-11,1,2015,3,0,2,1,994,6706,7700
2015-03-12,1,2015,3,0,3,1,1709,7290,8999
2015-03-13,1,2015,3,0,4,1,1352,6556,7908
2015-03-14,1,2015,3,0,5,1,758,2789,3547
2015-03-15,1,2015,3,0,6,0,1929,4487,6416
2015-03-16,1,2015,3,0,0,0,1574,7207,8781
2015-03-17,1,2015,3,0,1,1,1414,7613,9027
2015-03-18,1,2015,3,0,2,1,772,6610,7382
2015-03-19,1,2015,3,0,3,1,1137,6907,8044
2015-03-20,1,2015,3,0,4,1,145,2760,2905
2015-03-21,2,2015,3,0,5,1,3227,5816,9043
2015-03-22,2,2015,3,0,6,0,2639,5314,7953
2015-03-23,2,2015,3,0,0,0,1403,6564,7967
2015-03-24,2,2015,3,0,1,1,956,6773,7729
2015-03-25,2,2015,3,0,2,1,663,6760,7423
2015-03-26,2,2015,3,0,3,1,1156,7380,8536
2015-03-27,2,2015,3,0,4,1,834,5168,6002
2015-03-28,2,2015,3,0,5,1,854,3719,4573
2015-03-29,2,2015,3,0,6,0,1606,4066,5672
2015-03-30,2,2015,3,0,0,0,1543,7409,8952
2015-03-31,2,2015,3,0,1,1,1232,6779,8011
2015-04-01,2,2015,4,0,2,1,1780,8097,9877
2015-04-02,2,2015,4,0,3,1,2608,8668,11276
2015-04-03,2,2015,4,0,4,1,1177,5251,6428
2015-04-04,2,2015,4,0,5,1,5102,5336,10438
2015-04-05,2,2015,4,0,6,0,5228,4959,10187
2015-04-06,2,2015,4,0,0,0,3617,9023,12640
2015-04-07,2,2015,4,0,1,1,2498,8619,11117
2015-04-08,2,2015,4,0,2,1,993,6448,7441
2015-04-09,2,2015,4,0,3,1,1053,6775,7828
2015-04-10,2,2015,4,0,4,1,2200,7198,9398
2015-04-11,2,2015,4,0,5,1,8614,8132,16746
2015-04-12,2,2015,4,0,6,0,7838,7914,15752
2015-04-13,2,2015,4,0,0,0,3186,9510,12696
2015-04-14,2,2015,4,0,1,1,293,3532,3825
2015-04-15,2,2015,4,0,2,1,1886,9243,11129
2015-04-16,2,2015,4,0,3,1,2012,9679,11691
2015-04-17,2,2015,4,0,4,1,3141,9409,12550
2015-04-18,2,2015,4,0,5,1,7748,8260,16008
2015-04-19,2,2015,4,0,6,0,4436,5819,10255
2015-04-20,2,2015,4,0,0,0,1769,7299,9068
2015-04-21,2,2015,4,0,1,1,2050,9594,11644
2015-04-22,2,2015,4,0,2,1,1513,9032,10545
2015-04-23,2,2015,4,0,3,1,1611,8496,10107
2015-04-24,2,2015,4,0,4,1,2199,8177,10376
2015-04-25,2,2015,4,0,5,1,2684,4508,7192
2015-04-26,2,2015,4,0,6,0,4014,6323,10337
2015-04-27,2,2015,4,0,0,0,1221,7648,8869
2015-04-28,2,2015,4,0,1,1,1688,9311,10999
2015-04-29,2,2015,4,0,2,1,1939,9725,11664
2015-04-30,2,2015,4,0,3,1,1511,8746,10257
2015-05-01,2,2015,5,0,4,1,1778,8578,10356
2015-05-02,2,2015,5,0,5,1,5110,7469,12579
2015-05-03,2,2015,5,0,6,0,4986,7120,12106
2015-05-04,2,2015,5,0,0,0,2609,9383,11992
2015-05-05,2,2015,5,0,1,1,1785,9315,11100
2015-05-06,2,2015,5,0,2,1,1825,9664,11489
2015-05-07,2,2015,5,0,3,1,2131,10191,12322
2015-05-08,2,2015,5,0,4,1,2925,10506,13431
2015-05-09,2,2015,5,0,5,1,5134,7717,12851
2015-05-10,2,2015,5,0,6,0,4545,6555,11100
2015-05-11,2,2015,5,0,0,0,2530,9609,12139
2015-05-12,2,2015,5,0,1,1,2265,9802,12067
2015-05-13,2,2015,5,0,2,1,1763,10017,11780
2015-05-14,2,2015,5,0,3,1,2546,10071,12617
2015-05-15,2,2015,5,0,4,1,3365,10286,13651
2015-05-16,2,2015,5,0,5,1,4454,6754,11208
2015-05-17,2,2015,5,0,6,0,3966,6976,10942
2015-05-18,2,2015,5,0,0,0,2358,8087,10445
2015-05-19,2,2015,5,0,1,1,2182,9886,12068
2015-05-20,2,2015,5,0,2,1,2521,10465,12986
2015-05-21,2,2015,5,0,3,1,517,6466,6983
2015-05-22,2,2015,5,0,4,1,3183,9348,12531
2015-05-23,2,2015,5,0,5,1,6652,6068,12720
2015-05-24,2,2015,5,0,6,0,7787,5792,13579
2015-05-25,2,2015,5,1,0,0,5870,6139,12009
2015-05-26,2,2015,5,0,1,1,2263,9091,11354
2015-05-27,2,2015,5,0,2,1,1676,9799,11475
2015-05-28,2,2015,5,0,3,1,2100,9538,11638
2015-05-29,2,2015,5,0,4,1,2417,9650,12067
2015-05-30,2,2015,5,0,5,1,5062,7610,12672
2015-05-31,2,2015,5,0,6,0,4046,6882,10928
2015-06-01,2,2015,6,0,0,0,1498,6608,8106
2015-06-02,2,2015,6,0,1,1,901,7154,8055
2015-06-03,2,2015,6,0,2,1,1121,8761,9882
2015-06-04,2,2015,6,0,3,1,847,5513,6360
2015-06-05,2,2015,6,0,4,1,2074,9008,11082
2015-06-06,2,2015,6,0,5,1,4674,8011,12685
2015-06-07,2,2015,6,0,6,0,4543,7132,11675
2015-06-08,2,2015,6,0,0,0,1838,8129,9967
2015-06-09,2,2015,6,0,1,1,1856,9916,11772
2015-06-10,2,2015,6,0,2,1,1572,10018,11590
2015-06-11,2,2015,6,0,3,1,2033,9821,11854
2015-06-12,2,2015,6,0,4,1,2109,8763,10872
2015-06-13,2,2015,6,0,5,1,4436,7332,11768
2015-06-14,2,2015,6,0,6,0,3265,6250,9515
2015-06-15,2,2015,6,0,0,0,1919,8068,9987
2015-06-16,2,2015,6,0,1,1,1866,9634,11500
2015-06-17,2,2015,6,0,2,1,1837,9338,11175
2015-06-18,2,2015,6,0,3,1,1530,8465,9995
2015-06-19,2,2015,6,0,4,1,2463,9561,12024
2015-06-20,2,2015,6,0,5,1,3448,5870,9318
2015-06-21,3,2015,6,0,6,0,2264,6520,8784
2015-06-22,3,2015,6,0,0,0,2191,9072,11263
2015-06-23,3,2015,6,0,1,1,1286,7904,9190
2015-06-24,3,2015,6,0,2,1,2212,10378,12590
2015-06-25,3,2015,6,0,3,1,2099,9032,11131
2015-06-26,3,2015,6,0,4,1,2963,10079,13042
2015-06-27,3,2015,6,0,5,1,683,2622,3305
2015-06-28,3,2015,6,0,6,0,4273,7348,11621
2015-06-29,3,2015,6,0,0,0,2713,9492,12205
2015-06-30,3,2015,6,0,1,1,2136,9844,11980
2015-07-01,3,2015,7,0,2,1,2308,8915,11223
2015-07-02,3,2015,7,0,3,1,2488,8769,11257
2015-07-03,3,2015,7,1,4,0,6429,6362,12791
2015-07-04,3,2015,7,1,5,0,5755,4533,10288
2015-07-05,3,2015,7,0,6,0,6211,5988,12199
2015-07-06,3,2015,7,0,0,0,2614,8288,10902
2015-07-07,3,2015,7,0,1,1,2393,9830,12223
2015-07-08,3,2015,7,0,2,1,1683,7812,9495
2015-07-09,3,2015,7,0,3,1,1916,9129,11045
2015-07-10,3,2015,7,0,4,1,3072,9941,13013
2015-07-11,3,2015,7,0,5,1,4847,7573,12420
2015-07-12,3,2015,7,0,6,0,4314,7397,11711
2015-07-13,3,2015,7,0,0,0,1864,8360,10224
2015-07-14,3,2015,7,0,1,1,1975,9616,11591
2015-07-15,3,2015,7,0,2,1,2039,10049,12088
2015-07-16,3,2015,7,0,3,1,2516,10741,13257
2015-07-17,3,2015,7,0,4,1,2977,9650,12627
2015-07-18,3,2015,7,0,5,1,4426,6670,11096
2015-07-19,3,2015,7,0,6,0,4155,5993,10148
2015-07-20,3,2015,7,0,0,0,2318,8538,10856
2015-07-21,3,2015,7,0,1,1,2246,9565,11811
2015-07-22,3,2015,7,0,2,1,2468,10466,12934
2015-07-23,3,2015,7,0,3,1,2575,10417,12992
2015-07-24,3,2015,7,0,4,1,3280,10059,13339
2015-07-25,3,2015,7,0,5,1,5807,7095,12902
2015-07-26,3,2015,7,0,6,0,4682,6632,11314
2015-07-27,3,2015,7,0,0,0,2482,8437,10919
2015-07-28,3,2015,7,0,1,1,2528,9448,11976
2015-07-29,3,2015,7,0,2,1,2428,9742,12170
2015-07-30,3,2015,7,0,3,1,1803,9005,10808
2015-07-31,3,2015,7,0,4,1,2751,9645,12396
2015-08-01,3,2015,8,0,5,1,4940,7103,12043
2015-08-02,3,2015,8,0,6,0,4550,6897,11447
2015-08-03,3,2015,8,0,0,0,2714,9371,12085
2015-08-04,3,2015,8,0,1,1,2212,9414,11626
2015-08-05,3,2015,8,0,2,1,2408,10093,12501
2015-08-06,3,2015,8,0,3,1,2565,10052,12617
2015-08-07,3,2015,8,0,4,1,2827,9354,12181
2015-08-08,3,2015,8,0,5,1,5843,7127,12970
2015-08-09,3,2015,8,0,6,0,4923,6728,11651
2015-08-10,3,2015,8,0,0,0,2362,8132,10494
2015-08-11,3,2015,8,0,1,1,2065,9277,11342
2015-08-12,3,2015,8,0,2,1,2304,10181,12485
2015-08-13,3,2015,8,0,3,1,2344,10091,12435
2015-08-14,3,2015,8,0,4,1,2972,9577,12549
2015-08-15,3,2015,8,0,5,1,5261,6821,12082
2015-08-16,3,2015,8,0,6,0,3872,6320,10192
2015-08-17,3,2015,8,0,0,0,2135,8836,10971
2015-08-18,3,2015,8,0,1,1,2098,9497,11595
2015-08-19,3,2015,8,0,2,1,1985,9981,11966
2015-08-20,3,2015,8,0,3,1,1823,8369,10192
2015-08-21,3,2015,8,0,4,1,3064,9838,12902
2015-08-22,3,2015,8,0,5,1,4995,7344,12339
2015-08-23,3,2015,8,0,6,0,4119,6862,10981
2015-08-24,3,2015,8,0,0,0,1963,8320,10283
2015-08-25,3,2015,8,0,1,1,2220,10452,12672
2015-08-26,3,2015,8,0,2,1,1933,10397,12330
2015-08-27,3,2015,8,0,3,1,2022,10384,12406
2015-08-28,3,2015,8,0,4,1,2440,9770,12210
2015-08-29,3,2015,8,0,5,1,4426,7100,11526
2015-08-30,3,2015,8,0,6,0,3512,6676,10188
2015-08-31,3,2015,8,0,0,0,1716,9336,11052
2015-09-01,3,2015,9,0,1,1,1504,10018,11522
2015-09-02,3,2015,9,0,2,1,1545,9833,11378
2015-09-03,3,2015,9,0,3,1,1670,9461,11131
2015-09-04,3,2015,9,0,4,1,2187,8863,11050
2015-09-05,3,2015,9,0,5,1,5260,5607,10867
2015-09-06,3,2015,9,0,6,0,6970,5430,12400
2015-09-07,3,2015,9,1,0,0,4295,6056,10351
2015-09-08,3,2015,9,0,1,1,1381,9584,10965
2015-09-09,3,2015,9,0,2,1,1352,9713,11065
2015-09-10,3,2015,9,0,3,1,1078,9278,10356
2015-09-11,3,2015,9,0,4,1,2085,10082,12167
2015-09-12,3,2015,9,0,5,1,1417,5248,6665
2015-09-13,3,2015,9,0,6,0,3127,7270,10397
2015-09-14,3,2015,9,0,0,0,1592,9564,11156
2015-09-15,3,2015,9,0,1,1,1540,10403,11943
2015-09-16,3,2015,9,0,2,1,1485,10453,11938
2015-09-17,3,2015,9,0,3,1,1561,10388,11949
2015-09-18,3,2015,9,0,4,1,1809,10147,11956
2015-09-19,3,2015,9,0,5,1,3971,7609,11580
2015-09-20,3,2015,9,0,6,0,3604,7394,10998
2015-09-21,3,2015,9,0,0,0,1314,6502,7816
2015-09-22,3,2015,9,0,1,1,1783,10169,11952
2015-09-23,4,2015,9,0,2,1,2339,10434,12773
2015-09-24,4,2015,9,0,3,1,2320,10194,12514
2015-09-25,4,2015,9,0,4,1,1814,9589,11403
2015-09-26,4,2015,9,0,5,1,3509,7529,11038
2015-09-27,4,2015,9,0,6,0,2892,7087,9979
2015-09-28,4,2015,9,0,0,0,1569,9736,11305
2015-09-29,4,2015,9,0,1,1,930,6310,7240
2015-09-30,4,2015,9,0,2,1,1047,9137,10184
2015-10-01,4,2015,10,0,3,1,224,4575,4799
2015-10-02,4,2015,10,0,4,1,104,1975,2079
2015-10-03,4,2015,10,0,5,1,598,3452,4050
2015-10-04,4,2015,10,0,6,0,1311,5313,6624
2015-10-05,4,2015,10,0,0,0,1234,9211,10445
2015-10-06,4,2015,10,0,1,1,1203,10348,11551
2015-10-07,4,2015,10,0,2,1,1181,10553,11734
2015-10-08,4,2015,10,0,3,1,1474,10237,11711
2015-10-09,4,2015,10,0,4,1,1829,8672,10501
2015-10-10,4,2015,10,0,5,1,3800,6469,10269
2015-10-11,4,2015,10,0,6,0,4380,6111,10491
2015-10-12,4,2015,10,1,0,0,2889,7606,10495
2015-10-13,4,2015,10,0,1,1,1294,9509,10803
2015-10-14,4,2015,10,0,2,1,1214,10192,11406
2015-10-15,4,2015,10,0,3,1,1654,9852,11506
2015-10-16,4,2015,10,0,4,1,1874,9389,11263
2015-10-17,4,2015,10,0,5,1,2861,5921,8782
2015-10-18,4,2015,10,0,6,0,1788,5190,6978
2015-10-19,4,2015,10,0,0,0,913,8161,9074
2015-10-20,4,2015,10,0,1,1,933,9103,10036
2015-10-21,4,2015,10,0,2,1,1056,9622,10678
2015-10-22,4,2015,10,0,3,1,1643,9644,11287
2015-10-23,4,2015,10,0,4,1,2136,9334,11470
2015-10-24,4,2015,10,0,5,1,3434,6296,9730
2015-10-25,4,2015,10,0,6,0,2654,5933,8587
2015-10-26,4,2015,10,0,0,0,1434,8539,9973
2015-10-27,4,2015,10,0,1,1,939,8858,9797
2015-10-28,4,2015,10,0,2,1,201,4978,5179
2015-10-29,4,2015,10,0,3,1,1142,9490,10632
2015-10-30,4,2015,10,0,4,1,1125,8575,9700
2015-10-31,4,2015,10,0,5,1,2425,6296,8721
2015-11-01,4,2015,11,0,6,0,1897,5314,7211
2015-11-02,4,2015,11,0,0,0,1051,8395,9446
2015-11-03,4,2015,11,0,1,1,985,9523,10508
2015-11-04,4,2015,11,0,2,1,1092,9730,10822
2015-11-05,4,2015,11,0,3,1,1073,9480,10553
2015-11-06,4,2015,11,0,4,1,2155,9454,11609
2015-11-07,4,2015,11,0,5,1,1148,4462,5610
2015-11-08,4,2015,11,0,6,0,2790,6204,8994
2015-11-09,4,2015,11,0,0,0,564,6151,6715
2015-11-10,4,2015,11,0,1,1,248,5525,5773
2015-11-11,4,2015,11,1,2,0,945,7956,8901
2015-11-12,4,2015,11,0,3,1,543,7933,8476
2015-11-13,4,2015,11,0,4,1,928,8334,9262
2015-11-14,4,2015,11,0,5,1,1823,5348,7171
2015-11-15,4,2015,11,0,6,0,1932,5509,7441
2015-11-16,4,2015,11,0,0,0,757,8399,9156
2015-11-17,4,2015,11,0,1,1,652,8574,9226
2015-11-18,4,2015,11,0,2,1,752,9016,9768
2015-11-19,4,2015,11,0,3,1,258,5997,6255
2015-11-20,4,2015,11,0,4,1,947,8150,9097
2015-11-21,4,2015,11,0,5,1,1867,5432,7299
2015-11-22,4,2015,11,0,6,0,819,4129,4948
2015-11-23,4,2015,11,0,0,0,313,6288,6601
2015-11-24,4,2015,11,0,1,1,506,6994,7500
2015-11-25,4,2015,11,0,2,1,696,6168,6864
2015-11-26,4,2015,11,1,3,0,1366,2028,3394
2015-11-27,4,2015,11,0,4,1,2857,3383,6240
2015-11-28,4,2015,11,0,5,1,2824,3594,6418
2015-11-29,4,2015,11,0,6,0,343,2534,2877
2015-11-30,4,2015,11,0,0,0,114,4046,4160
2015-12-01,4,2015,12,0,1,1,73,3881,3954
2015-12-02,4,2015,12,0,2,1,160,5580,5740
2015-12-03,4,2015,12,0,3,1,308,7661,7969
2015-12-04,4,2015,12,0,4,1,478,7462,7940
2015-12-05,4,2015,12,0,5,1,1461,5625,7086
2015-12-06,4,2015,12,0,6,0,1104,4876,5980
2015-12-07,4,2015,12,0,0,0,559,7369,7928
2015-12-08,4,2015,12,0,1,1,483,7975,8458
2015-12-09,4,2015,12,0,2,1,301,7681,7982
2015-12-10,4,2015,12,0,3,1,561,8124,8685
2015-12-11,4,2015,12,0,4,1,797,7925,8722
2015-12-12,4,2015,12,0,5,1,2300,6420,8720
2015-12-13,4,2015,12,0,6,0,1933,6101,8034
2015-12-14,4,2015,12,0,0,0,545,6100,6645
2015-12-15,4,2015,12,0,1,1,526,8277,8803
2015-12-16,4,2015,12,0,2,1,595,8030,8625
2015-12-17,4,2015,12,0,3,1,135,4418,4553
2015-12-18,4,2015,12,0,4,1,344,6354,6698
2015-12-19,4,2015,12,0,5,1,532,3747,4279
2015-12-20,4,2015,12,0,6,0,574,3645,4219
2015-12-21,1,2015,12,0,0,0,591,6084,6675
2015-12-22,1,2015,12,0,1,1,396,4538,4934
2015-12-23,1,2015,12,0,2,1,101,2162,2263
2015-12-24,1,2015,12,0,3,1,465,2331,2796
2015-12-25,1,2015,12,1,4,0,730,772,1502
2015-12-26,1,2015,12,0,5,1,1029,1673,2702
2015-12-27,1,2015,12,0,6,0,2249,2374,4623
2015-12-28,1,2015,12,0,0,0,838,3621,4459
2015-12-29,1,2015,12,0,1,1,1004,4249,5253
2015-12-30,1,2015,12,0,2,1,1038,4237,5275
2015-12-31,1,2015,12,0,3,1,1291,4564,5855
2016-01-01,1,2016,1,1,4,0,999,2221,3220
2016-01-02,1,2016,1,0,5,1,1522,3399,4921
2016-01-03,1,2016,1,0,6,0,1242,3723,4965
2016-01-04,1,2016,1,0,0,0,274,4859,5133
2016-01-05,1,2016,1,0,1,1,249,4601,4850
2016-01-06,1,2016,1,0,2,1,253,5459,5712
2016-01-07,1,2016,1,0,3,1,371,6221,6592
2016-01-08,1,2016,1,0,4,1,347,5806,6153
2016-01-09,1,2016,1,0,5,1,765,4549,5314
2016-01-10,1,2016,1,0,6,0,956,4707,5663
2016-01-11,1,2016,1,0,0,0,428,5866,6294
2016-01-12,1,2016,1,0,1,1,387,6103,6490
2016-01-13,1,2016,1,0,2,1,271,5349,5620
2016-01-14,1,2016,1,0,3,1,478,6686,7164
2016-01-15,1,2016,1,0,4,1,506,5477,5983
2016-01-16,1,2016,1,0,5,1,1436,4472,5908
2016-01-17,1,2016,1,0,6,0,606,2794,3400
2016-01-18,1,2016,1,1,0,0,142,2357,2499
2016-01-19,1,2016,1,0,1,1,57,3855,3912
2016-01-20,1,2016,1,0,2,1,64,4257,4321
2016-01-21,1,2016,1,0,3,1,71,4157,4228
2016-01-22,1,2016,1,0,4,1,62,2923,2985
2016-01-27,1,2016,1,0,2,1,3,525,528
2016-01-28,1,2016,1,0,3,1,38,1984,2022
2016-01-29,1,2016,1,0,4,1,94,2848,2942
2016-01-30,1,2016,1,0,5,1,321,2501,2822
2016-01-31,1,2016,1,0,6,0,477,3134,3611
2016-02-01,1,2016,2,0,0,0,190,4414,4604
2016-02-02,1,2016,2,0,1,1,227,6357,6584
2016-02-03,1,2016,2,0,2,1,72,4171,4243
2016-02-04,1,2016,2,0,3,1,301,6390,6691
2016-02-05,1,2016,2,0,4,1,382,5440,5822
2016-02-06,1,2016,2,0,5,1,788,4254,5042
2016-02-07,1,2016,2,0,6,0,671,3993,4664
2016-02-08,1,2016,2,0,0,0,266,5728,5994
2016-02-09,1,2016,2,0,1,1,111,3942,4053
2016-02-10,1,2016,2,0,2,1,184,5309,5493
2016-02-11,1,2016,2,0,3,1,91,4155,4246
2016-02-12,1,2016,2,0,4,1,172,4191,4363
2016-02-13,1,2016,2,0,5,1,118,1417,1535
2016-02-14,1,2016,2,0,6,0,225,1626,1851
2016-02-15,1,2016,2,1,0,0,24,477,501
2016-02-16,1,2016,2,0,1,1,83,3155,3238
2016-02-17,1,2016,2,0,2,1,241,5856,6097
2016-02-18,1,2016,2,0,3,1,217,5605,5822
2016-02-19,1,2016,2,0,4,1,289,5344,5633
2016-02-20,1,2016,2,0,5,1,2651,5594,8245
2016-02-21,1,2016,2,0,6,0,733,3521,4254
2016-02-22,1,2016,2,0,0,0,522,6626,7148
2016-02-23,1,2016,2,0,1,1,57,2528,2585
2016-02-24,1,2016,2,0,2,1,67,3212,3279
2016-02-25,1,2016,2,0,3,1,169,6161,6330
2016-02-26,1,2016,2,0,4,1,146,5199,5345
2016-02-27,1,2016,2,0,5,1,982,4450,5432
2016-02-28,1,2016,2,0,6,0,2792,5940,8732
2016-02-29,1,2016,2,0,0,0,647,7181,7828
2016-03-01,1,2016,3,0,1,1,686,7902,8588
2016-03-02,1,2016,3,0,2,1,210,5708,5918
2016-03-03,1,2016,3,0,3,1,251,5651,5902
2016-03-04,1,2016,3,0,4,1,273,5072,5345
2016-03-05,1,2016,3,0,5,1,1109,4225,5334
2016-03-06,1,2016,3,0,6,0,1539,4360,5899
2016-03-07,1,2016,3,0,0,0,1479,7524,9003
2016-03-08,1,2016,3,0,1,1,1670,8888,10558
2016-03-09,1,2016,3,0,2,1,1925,9289,11214
2016-03-10,1,2016,3,0,3,1,1910,9044,10954
2016-03-11,1,2016,3,0,4,1,2290,8929,11219
2016-03-12,1,2016,3,0,5,1,3962,6466,10428
2016-03-13,1,2016,3,0,6,0,1426,3768,5194
2016-03-14,1,2016,3,0,0,0,870,6801,7671
2016-03-15,1,2016,3,0,1,1,1015,7543,8558
2016-03-16,1,2016,3,0,2,1,3953,9403,13356
2016-03-17,1,2016,3,0,3,1,1786,8887,10673
2016-03-18,1,2016,3,0,4,1,2561,8868,11429
2016-03-19,1,2016,3,0,5,1,496,2731,3227
2016-03-20,1,2016,3,0,6,0,763,3769,4532
2016-03-21,2,2016,3,0,0,0,838,6742,7580
2016-03-22,2,2016,3,0,1,1,1410,8353,9763
2016-03-23,2,2016,3,0,2,1,2380,9960,12340
2016-03-24,2,2016,3,0,3,1,3139,10224,13363
2016-03-25,2,2016,3,0,4,1,3274,8938,12212
2016-03-26,2,2016,3,0,5,1,7027,7089,14116
2016-03-27,2,2016,3,0,6,0,3745,4819,8564
2016-03-28,2,2016,3,0,0,0,1485,6945,8430
2016-03-29,2,2016,3,0,1,1,1658,8563,10221
2016-03-30,2,2016,3,0,2,1,2050,8823,10873
2016-03-31,2,2016,3,0,3,1,1950,9079,11029
2016-04-01,2,2016,4,0,4,1,2542,8332,10874
2016-04-02,2,2016,4,0,5,1,3478,5804,9282
2016-04-03,2,2016,4,0,6,0,1921,4879,6800
2016-04-04,2,2016,4,0,0,0,971,6427,7398
2016-04-05,2,2016,4,0,1,1,645,6867,7512
2016-04-06,2,2016,4,0,2,1,1055,8013,9068
2016-04-07,2,2016,4,0,3,1,490,4943,5433
2016-04-08,2,2016,4,0,4,1,1651,7878,9529
2016-04-09,2,2016,4,0,5,1,795,3274,4069
2016-04-10,2,2016,4,0,6,0,2507,4914,7421
2016-04-11,2,2016,4,0,0,0,1479,7977,9456
2016-04-12,2,2016,4,0,1,1,926,7657,8583
2016-04-13,2,2016,4,0,2,1,1152,8979,10131
2016-04-14,2,2016,4,0,3,1,1323,9200,10523
2016-04-15,2,2016,4,0,4,1,2329,9066,11395
2016-04-16,2,2016,4,0,5,1,5969,7536,13505
2016-04-17,2,2016,4,0,6,0,5252,7115,12367
2016-04-18,2,2016,4,0,0,0,2409,9473,11882
2016-04-19,2,2016,4,0,1,1,1962,9965,11927
2016-04-20,2,2016,4,0,2,1,1712,9938,11650
2016-04-21,2,2016,4,0,3,1,1738,9709,11447
2016-04-22,2,2016,4,0,4,1,2068,9025,11093
2016-04-23,2,2016,4,0,5,1,3018,5469,8487
2016-04-24,2,2016,4,0,6,0,4816,7132,11948
2016-04-25,2,2016,4,0,0,0,2296,9398,11694
2016-04-26,2,2016,4,0,1,1,1754,9964,11718
2016-04-27,2,2016,4,0,2,1,924,7436,8360
2016-04-28,2,2016,4,0,3,1,353,4842,5195
2016-04-29,2,2016,4,0,4,1,1055,7203,8258
2016-04-30,2,2016,4,0,5,1,2845,5666,8511
2016-05-01,2,2016,5,0,6,0,947,3429,4376
2016-05-02,2,2016,5,0,0,0,1275,6864,8139
2016-05-03,2,2016,5,0,1,1,803,7329,8132
2016-05-04,2,2016,5,0,2,1,1018,8607,9625
2016-05-05,2,2016,5,0,3,1,893,7833,8726
2016-05-06,2,2016,5,0,4,1,169,2933,3102
2016-05-07,2,2016,5,0,5,1,2879,6346,9225
2016-05-08,2,2016,5,0,6,0,4057,6746,10803
2016-05-09,2,2016,5,0,0,0,1022,8142,9164
2016-05-10,2,2016,5,0,1,1,1311,8931,10242
2016-05-11,2,2016,5,0,2,1,620,7049,7669
2016-05-12,2,2016,5,0,3,1,1488,9317,10805
2016-05-13,2,2016,5,0,4,1,1543,8563,10106
2016-05-14,2,2016,5,0,5,1,3362,6027,9389
2016-05-15,2,2016,5,0,6,0,2686,5821,8507
2016-05-16,2,2016,5,0,0,0,2267,9090,11357
2016-05-17,2,2016,5,0,1,1,293,5081,5374
2016-05-18,2,2016,5,0,2,1,1162,9421,10583
2016-05-19,2,2016,5,0,3,1,1940,9780,11720
2016-05-20,2,2016,5,0,4,1,3238,10622,13860
2016-05-21,2,2016,5,0,5,1,1059,3373,4432
2016-05-22,2,2016,5,0,6,0,426,2425,2851
2016-05-23,2,2016,5,0,0,0,1249,6799,8048
2016-05-24,2,2016,5,0,1,1,2397,10838,13235
2016-05-25,2,2016,5,0,2,1,2220,10566,12786
2016-05-26,2,2016,5,0,3,1,1881,10307,12188
2016-05-27,2,2016,5,0,4,1,2767,9372,12139
2016-05-28,2,2016,5,0,5,1,5846,5714,11560
2016-05-29,2,2016,5,0,6,0,4911,4158,9069
2016-05-30,2,2016,5,1,0,0,4229,5701,9930
2016-05-31,2,2016,5,0,1,1,2045,9533,11578
2016-06-01,2,2016,6,0,2,1,1669,10686,12355
2016-06-02,2,2016,6,0,3,1,1671,10695,12366
2016-06-03,2,2016,6,0,4,1,1448,7069,8517
2016-06-04,2,2016,6,0,5,1,4286,7705,11991
2016-06-05,2,2016,6,0,6,0,2851,6527,9378
2016-06-06,2,2016,6,0,0,0,2055,10413,12468
2016-06-07,2,2016,6,0,1,1,2118,11153,13271
2016-06-08,2,2016,6,0,2,1,2097,11489,13586
2016-06-09,2,2016,6,0,3,1,2217,11206,13423
2016-06-10,2,2016,6,0,4,1,2891,10839,13730
2016-06-11,2,2016,6,0,5,1,4328,7665,11993
2016-06-12,2,2016,6,0,6,0,4153,6870,11023
2016-06-13,2,2016,6,0,0,0,2607,10554,13161
2016-06-14,2,2016,6,0,1,1,2409,11540,13949
2016-06-15,2,2016,6,0,2,1,2277,10677,12954
2016-06-16,2,2016,6,0,3,1,1778,9278,11056
2016-06-17,2,2016,6,0,4,1,2826,10464,13290
2016-06-18,2,2016,6,0,5,1,5823,7727,13550
2016-06-19,2,2016,6,0,6,0,4779,7051,11830
2016-06-20,2,2016,6,0,0,0,2818,10094,12912
2016-06-21,3,2016,6,0,1,1,1672,7841,9513
2016-06-22,3,2016,6,0,2,1,2876,11026,13902
2016-06-23,3,2016,6,0,3,1,1598,7837,9435
2016-06-24,3,2016,6,0,4,1,2617,9788,12405
2016-06-25,3,2016,6,0,5,1,5858,7742,13600
2016-06-26,3,2016,6,0,6,0,5274,7082,12356
2016-06-27,3,2016,6,0,0,0,2332,9590,11922
2016-06-28,3,2016,6,0,1,1,1624,9440,11064
2016-06-29,3,2016,6,0,2,1,2464,11314,13778
2016-06-30,3,2016,6,0,3,1,2396,10923,13319
2016-07-01,3,2016,7,0,4,1,3026,9379,12405
2016-07-02,3,2016,7,0,5,1,7360,6712,14072
2016-07-03,3,2016,7,0,6,0,7759,5277,13036
2016-07-04,3,2016,7,1,0,0,3708,3892,7600
2016-07-05,3,2016,7,0,1,1,3107,8863,11970
2016-07-06,3,2016,7,0,2,1,2531,9917,12448
2016-07-07,3,2016,7,0,3,1,2270,9948,12218
2016-07-08,3,2016,7,0,4,1,2309,9272,11581
2016-07-09,3,2016,7,0,5,1,4818,7380,12198
2016-07-10,3,2016,7,0,6,0,4681,7300,11981
2016-07-11,3,2016,7,0,0,0,2751,9959,12710
2016-07-12,3,2016,7,0,1,1,2543,10625,13168
2016-07-13,3,2016,7,0,2,1,2311,10209,12520
2016-07-14,3,2016,7,0,3,1,2433,9653,12086
2016-07-15,3,2016,7,0,4,1,3111,9502,12613
2016-07-16,3,2016,7,0,5,1,7359,6478,13837
2016-07-17,3,2016,7,0,6,0,8629,6897,15526
2016-07-18,3,2016,7,0,0,0,2225,7504,9729
2016-07-19,3,2016,7,0,1,1,2383,9942,12325
2016-07-20,3,2016,7,0,2,1,2569,10731,13300
2016-07-21,3,2016,7,0,3,1,2528,10334,12862
2016-07-22,3,2016,7,0,4,1,3033,9072,12105
2016-07-23,3,2016,7,0,5,1,4167,6094,10261
2016-07-24,3,2016,7,0,6,0,3986,5629,9615
2016-07-25,3,2016,7,0,0,0,2202,8073,10275
2016-07-26,3,2016,7,0,1,1,2107,9043,11150
2016-07-27,3,2016,7,0,2,1,2062,9506,11568
2016-07-28,3,2016,7,0,3,1,1813,7553,9366
2016-07-29,3,2016,7,0,4,1,3061,9090,12151
2016-07-30,3,2016,7,0,5,1,3708,5230,8938
2016-07-31,3,2016,7,0,6,0,4398,6446,10844
2016-08-01,3,2016,8,0,0,0,2713,9238,11951
2016-08-02,3,2016,8,0,1,1,2771,10603,13374
2016-08-03,3,2016,8,0,2,1,2912,10679,13591
2016-08-04,3,2016,8,0,3,1,3157,10398,13555
2016-08-05,3,2016,8,0,4,1,3462,9724,13186
2016-08-06,3,2016,8,0,5,1,4894,6446,11340
2016-08-07,3,2016,8,0,6,0,5122,6840,11962
2016-08-08,3,2016,8,0,0,0,2708,9218,11926
2016-08-09,3,2016,8,0,1,1,2562,9862,12424
2016-08-10,3,2016,8,0,2,1,2392,9866,12258
2016-08-11,3,2016,8,0,3,1,2496,8970,11466
2016-08-12,3,2016,8,0,4,1,2627,8226,10853
2016-08-13,3,2016,8,0,5,1,3400,5317,8717
2016-08-14,3,2016,8,0,6,0,2732,4976,7708
2016-08-15,3,2016,8,0,0,0,1766,7474,9240
2016-08-16,3,2016,8,0,1,1,2059,9257,11316
2016-08-17,3,2016,8,0,2,1,1977,9011,10988
2016-08-18,3,2016,8,0,3,1,2380,9441,11821
2016-08-19,3,2016,8,0,4,1,2669,9246,11915
2016-08-20,3,2016,8,0,5,1,4875,6659,11534
2016-08-21,3,2016,8,0,6,0,2666,4586,7252
2016-08-22,3,2016,8,0,0,0,2664,9685,12349
2016-08-23,3,2016,8,0,1,1,2433,10609,13042
2016-08-24,3,2016,8,0,2,1,2355,10398,12753
2016-08-25,3,2016,8,0,3,1,2427,10097,12524
2016-08-26,3,2016,8,0,4,1,2387,8909,11296
2016-08-27,3,2016,8,0,5,1,4447,6750,11197
2016-08-28,3,2016,8,0,6,0,3900,6628,10528
2016-08-29,3,2016,8,0,0,0,2056,9377,11433
2016-08-30,3,2016,8,0,1,1,1914,10302,12216
2016-08-31,3,2016,8,0,2,1,1553,10060,11613
2016-09-01,3,2016,9,0,3,1,1545,8453,9998
2016-09-02,3,2016,9,0,4,1,3174,9541,12715
2016-09-03,3,2016,9,0,5,1,5404,5623,11027
2016-09-04,3,2016,9,0,6,0,7296,5494,12790
2016-09-05,3,2016,9,1,0,0,4945,6275,11220
2016-09-06,3,2016,9,0,1,1,2086,9666,11752
2016-09-07,3,2016,9,0,2,1,1602,9426,11028
2016-09-08,3,2016,9,0,3,1,1679,9791,11470
2016-09-09,3,2016,9,0,4,1,2026,9389,11415
2016-09-10,3,2016,9,0,5,1,3528,6848,10376
2016-09-11,3,2016,9,0,6,0,4217,7368,11585
2016-09-12,3,2016,9,0,0,0,2284,10027,12311
2016-09-13,3,2016,9,0,1,1,2110,10695,12805
2016-09-14,3,2016,9,0,2,1,1911,10614,12525
2016-09-15,3,2016,9,0,3,1,2232,11041,13273
2016-09-16,3,2016,9,0,4,1,2842,10369,13211
2016-09-17,3,2016,9,0,5,1,5041,7861,12902
2016-09-18,3,2016,9,0,6,0,4253,7094,11347
2016-09-19,3,2016,9,0,0,0,953,7511,8464
2016-09-20,3,2016,9,0,1,1,1926,10704,12630
2016-09-21,3,2016,9,0,2,1,1859,10630,12489
2016-09-22,3,2016,9,0,3,1,2046,10684,12730
2016-09-23,4,2016,9,0,4,1,2987,10355,13342
2016-09-24,4,2016,9,0,5,1,5192,7914,13106
2016-09-25,4,2016,9,0,6,0,4674,7275,11949
2016-09-26,4,2016,9,0,0,0,1844,9608,11452
2016-09-27,4,2016,9,0,1,1,1883,10474,12357
2016-09-28,4,2016,9,0,2,1,946,6781,7727
2016-09-29,4,2016,9,0,3,1,495,5391,5886
2016-09-30,4,2016,9,0,4,1,1216,7310,8526
2016-10-01,4,2016,10,0,5,1,1782,4847,6629
2016-10-02,4,2016,10,0,6,0,3910,6534,10444
2016-10-03,4,2016,10,0,0,0,2445,9856,12301
2016-10-04,4,2016,10,0,1,1,2237,10557,12794
2016-10-05,4,2016,10,0,2,1,1855,10735,12590
2016-10-06,4,2016,10,0,3,1,2178,10184,12362
2016-10-07,4,2016,10,0,4,1,3358,9837,13195
2016-10-08,4,2016,10,0,5,1,1498,3627,5125
2016-10-09,4,2016,10,0,6,0,4004,6022,10026
2016-10-10,4,2016,10,1,0,0,3167,7248,10415
2016-10-11,4,2016,10,0,1,1,1870,9659,11529
2016-10-12,4,2016,10,0,2,1,1919,9878,11797
2016-10-13,4,2016,10,0,3,1,2090,10149,12239
2016-10-14,4,2016,10,0,4,1,2956,9515,12471
2016-10-15,4,2016,10,0,5,1,5442,6877,12319
2016-10-16,4,2016,10,0,6,0,4547,6706,11253
2016-10-17,4,2016,10,0,0,0,2462,9443,11905
2016-10-18,4,2016,10,0,1,1,2192,10794,12986
2016-10-19,4,2016,10,0,2,1,2121,10800,12921
2016-10-20,4,2016,10,0,3,1,2426,10594,13020
2016-10-21,4,2016,10,0,4,1,1905,8680,10585
2016-10-22,4,2016,10,0,5,1,2829,6075,8904
2016-10-23,4,2016,10,0,6,0,3625,5980,9605
2016-10-24,4,2016,10,0,0,0,1724,9076,10800
2016-10-25,4,2016,10,0,1,1,1519,9662,11181
2016-10-26,4,2016,10,0,2,1,1335,9362,10697
2016-10-27,4,2016,10,0,3,1,860,8420,9280
2016-10-28,4,2016,10,0,4,1,1720,8907,10627
2016-10-29,4,2016,10,0,5,1,4623,6992,11615
2016-10-30,4,2016,10,0,6,0,4536,6366,10902
2016-10-31,4,2016,10,0,0,0,1886,8840,10726
2016-11-01,4,2016,11,0,1,1,1488,9881,11369
2016-11-02,4,2016,11,0,2,1,1629,10494,12123
2016-11-03,4,2016,11,0,3,1,1661,10297,11958
2016-11-04,4,2016,11,0,4,1,2398,9582,11980
2016-11-05,4,2016,11,0,5,1,4527,6776,11303
2016-11-06,4,2016,11,0,6,0,3646,6194,9840
2016-11-07,4,2016,11,0,0,0,1452,8703,10155
2016-11-08,4,2016,11,0,1,1,1864,10162,12026
2016-11-09,4,2016,11,0,2,1,946,6453,7399
2016-11-10,4,2016,11,0,3,1,1377,8874,10251
2016-11-11,4,2016,11,1,4,0,2595,7253,9848
2016-11-12,4,2016,11,0,5,1,3192,5135,8327
2016-11-13,4,2016,11,0,6,0,2970,5185,8155
2016-11-14,4,2016,11,0,0,0,1275,7935,9210
2016-11-15,4,2016,11,0,1,1,1201,9194,10395
2016-11-16,4,2016,11,0,2,1,1136,8910,10046
2016-11-17,4,2016,11,0,3,1,1217,9278,10495
2016-11-18,4,2016,11,0,4,1,2059,9194,11253
2016-11-19,4,2016,11,0,5,1,3121,5126,8247
2016-11-20,4,2016,11,0,6,0,727,3099,3826
2016-11-21,4,2016,11,0,0,0,528,6298,6826
2016-11-22,4,2016,11,0,1,1,779,6847,7626
2016-11-23,4,2016,11,0,2,1,1172,5731,6903
2016-11-24,4,2016,11,1,3,0,1566,1762,3328
2016-11-25,4,2016,11,0,4,1,2850,2981,5831
2016-11-26,4,2016,11,0,5,1,2094,2897,4991
2016-11-27,4,2016,11,0,6,0,1216,3651,4867
2016-11-28,4,2016,11,0,0,0,691,7336,8027
2016-11-29,4,2016,11,0,1,1,287,6044,6331
2016-11-30,4,2016,11,0,2,1,349,5821,6170
2016-12-01,4,2016,12,0,3,1,656,8475,9131
2016-12-02,4,2016,12,0,4,1,921,7490,8411
2016-12-03,4,2016,12,0,5,1,1423,4786,6209
2016-12-04,4,2016,12,0,6,0,948,4316,5264
2016-12-05,4,2016,12,0,0,0,704,7506,8210
2016-12-06,4,2016,12,0,1,1,155,3738,3893
2016-12-07,4,2016,12,0,2,1,638,8017,8655
2016-12-08,4,2016,12,0,3,1,537,7456,7993
2016-12-09,4,2016,12,0,4,1,455,5964,6419
2016-12-10,4,2016,12,0,5,1,711,3491,4202
2016-12-11,4,2016,12,0,6,0,585,3230,3815
2016-12-12,4,2016,12,0,0,0,573,6464,7037
2016-12-13,4,2016,12,0,1,1,464,7279,7743
2016-12-14,4,2016,12,0,2,1,486,7124,7610
2016-12-15,4,2016,12,0,3,1,148,4408,4556
2016-12-16,4,2016,12,0,4,1,210,4307,4517
2016-12-17,4,2016,12,0,5,1,233,2086,2319
2016-12-18,4,2016,12,0,6,0,425,2888,3313
2016-12-19,4,2016,12,0,0,0,494,5834,6328
2016-12-20,4,2016,12,0,1,1,384,5722,6106
2016-12-21,1,2016,12,0,2,1,560,6027,6587
2016-12-22,1,2016,12,0,3,1,670,5517,6187
2016-12-23,1,2016,12,0,4,1,523,3686,4209
2016-12-24,1,2016,12,0,5,1,281,1091,1372
2016-12-25,1,2016,12,1,6,0,1240,915,2155
2016-12-26,1,2016,12,1,0,0,818,1543,2361
2016-12-27,1,2016,12,0,1,1,1645,4158,5803
2016-12-28,1,2016,12,0,2,1,1910,4486,6396
2016-12-29,1,2016,12,0,3,1,842,3412,4254
2016-12-30,1,2016,12,0,4,1,832,3615,4447
2016-12-31,1,2016,12,0,5,1,977,2240,3217
2017-01-01,1,2017,1,1,6,0,1580,2483,4063
2017-01-02,1,2017,1,1,0,0,181,1457,1638
2017-01-03,1,2017,1,0,1,1,254,3517,3771
2017-01-04,1,2017,1,0,2,1,748,6437,7185
2017-01-05,1,2017,1,0,3,1,402,5812,6214
2017-01-06,1,2017,1,0,4,1,309,5261,5570
2017-01-07,1,2017,1,0,5,1,131,1678,1809
2017-01-08,1,2017,1,0,6,0,142,1778,1920
2017-01-09,1,2017,1,0,0,0,194,4423,4617
2017-01-10,1,2017,1,0,1,1,244,5362,5606
2017-01-11,1,2017,1,0,2,1,589,6678,7267
2017-01-12,1,2017,1,0,3,1,944,8147,9091
2017-01-13,1,2017,1,0,4,1,899,7132,8031
2017-01-14,1,2017,1,0,5,1,165,1699,1864
2017-01-15,1,2017,1,0,6,0,1436,3912,5348
2017-01-16,1,2017,1,1,0,0,578,3907,4485
2017-01-17,1,2017,1,0,1,1,183,5391,5574
2017-01-18,1,2017,1,0,2,1,535,6810,7345
2017-01-19,1,2017,1,0,3,1,1031,6345,7376
2017-01-20,1,2017,1,0,4,1,1384,4182,5566
2017-01-21,1,2017,1,0,5,1,3412,4745,8157
2017-01-22,1,2017,1,0,6,0,1180,2886,4066
2017-01-23,1,2017,1,0,0,0,118,2787,2905
2017-01-24,1,2017,1,0,1,1,416,6973,7389
2017-01-25,1,2017,1,0,2,1,793,8230,9023
2017-01-26,1,2017,1,0,3,1,463,7585,8048
2017-01-27,1,2017,1,0,4,1,524,6363,6887
2017-01-28,1,2017,1,0,5,1,1336,4219,5555
2017-01-29,1,2017,1,0,6,0,1042,4208,5250
2017-01-30,1,2017,1,0,0,0,194,5226,5420
2017-01-31,1,2017,1,0,1,1,463,7301,7764
2017-02-01,1,2017,2,0,2,1,469,7762,8231
2017-02-02,1,2017,2,0,3,1,439,7210,7649
2017-02-03,1,2017,2,0,4,1,382,6161,6543
2017-02-04,1,2017,2,0,5,1,918,3889,4807
2017-02-05,1,2017,2,0,6,0,1143,4346,5489
2017-02-06,1,2017,2,0,0,0,879,7520,8399
2017-02-07,1,2017,2,0,1,1,963,8833,9796
2017-02-08,1,2017,2,0,2,1,1176,9443,10619
2017-02-09,1,2017,2,0,3,1,219,5150,5369
2017-02-10,1,2017,2,0,4,1,425,5549,5974
2017-02-11,1,2017,2,0,5,1,2045,4776,6821
2017-02-12,1,2017,2,0,6,0,1086,3637,4723
2017-02-13,1,2017,2,0,0,0,409,5955,6364
2017-02-14,1,2017,2,0,1,1,406,7003,7409
2017-02-15,1,2017,2,0,2,1,511,6974,7485
2017-02-16,1,2017,2,0,3,1,339,6088,6427
2017-02-17,1,2017,2,0,4,1,815,6467,7282
2017-02-18,1,2017,2,0,5,1,5531,5195,10726
2017-02-19,1,2017,2,0,6,0,7049,5301,12350
2017-02-20,1,2017,2,1,0,0,4138,5920,10058
2017-02-21,1,2017,2,0,1,1,1239,7576,8815
2017-02-22,1,2017,2,0,2,1,1227,8432,9659
2017-02-23,1,2017,2,0,3,1,2089,9655,11744
2017-02-24,1,2017,2,0,4,1,3365,9594,12959
2017-02-25,1,2017,2,0,5,1,2956,5218,8174
2017-02-26,1,2017,2,0,6,0,1918,4421,6339
2017-02-27,1,2017,2,0,0,0,937,7327,8264
2017-02-28,1,2017,2,0,1,1,949,6879,7828
2017-03-01,1,2017,3,0,2,1,865,8112,8977
2017-03-02,1,2017,3,0,3,1,696,7438,8134
2017-03-03,1,2017,3,0,4,1,641,6100,6741
2017-03-04,1,2017,3,0,5,1,1303,3980,5283
2017-03-05,1,2017,3,0,6,0,1293,3706,4999
2017-03-06,1,2017,3,0,0,0,1262,7321,8583
2017-03-07,1,2017,3,0,1,1,1189,7194,8383
2017-03-08,1,2017,3,0,2,1,2093,8878,10971
2017-03-09,1,2017,3,0,3,1,2625,9781,12406
2017-03-10,1,2017,3,0,4,1,564,5434,5998
2017-03-11,1,2017,3,0,5,1,1191,3925,5116
2017-03-12,1,2017,3,0,6,0,1275,3346,4621
2017-03-13,1,2017,3,0,0,0,849,5621,6470
2017-03-14,1,2017,3,0,1,1,111,1472,1583
2017-03-15,1,2017,3,0,2,1,90,3269,3359
2017-03-16,1,2017,3,0,3,1,381,4798,5179
2017-03-17,1,2017,3,0,4,1,1162,6045,7207
2017-03-18,1,2017,3,0,5,1,3718,4527,8245
2017-03-19,1,2017,3,0,6,0,1930,3759,5689
2017-03-20,1,2017,3,0,0,0,1839,7464,9303
2017-03-21,2,2017,3,0,1,1,1895,8717,10612
2017-03-22,2,2017,3,0,2,1,929,7384,8313
2017-03-23,2,2017,3,0,3,1,1099,7517,8616
2017-03-24,2,2017,3,0,4,1,1843,7243,9086
2017-03-25,2,2017,3,0,5,1,9024,7167,16191
2017-03-26,2,2017,3,0,6,0,2453,4168,6621
2017-03-27,2,2017,3,0,0,0,2805,8562,11367
2017-03-28,2,2017,3,0,1,1,1822,8622,10444
2017-03-29,2,2017,3,0,2,1,2997,9792,12789
2017-03-30,2,2017,3,0,3,1,1819,8505,10324
2017-03-31,2,2017,3,0,4,1,421,3372,3793
2017-04-01,2,2017,4,0,5,1,4509,5812,10321
2017-04-02,2,2017,4,0,6,0,6954,6760,13714
2017-04-03,2,2017,4,0,0,0,2512,8356,10868
2017-04-04,2,2017,4,0,1,1,2921,9745,12666
2017-04-05,2,2017,4,0,2,1,3191,10354,13545
2017-04-06,2,2017,4,0,3,1,583,5770,6353
2017-04-07,2,2017,4,0,4,1,996,6600,7596
2017-04-08,2,2017,4,0,5,1,6217,6291,12508
2017-04-09,2,2017,4,0,6,0,7917,7216,15133
2017-04-10,2,2017,4,0,0,0,4282,9460,13742
2017-04-11,2,2017,4,0,1,1,4858,10513,15371
2017-04-12,2,2017,4,0,2,1,3735,10353,14088
2017-04-13,2,2017,4,0,3,1,4859,10575,15434
2017-04-14,2,2017,4,0,4,1,6530,9508,16038
2017-04-15,2,2017,4,0,5,1,10173,6723,16896
2017-04-16,2,2017,4,0,6,0,7474,5655,13129
2017-04-17,2,2017,4,0,0,0,2633,7645,10278
2017-04-18,2,2017,4,0,1,1,3406,10346,13752
2017-04-19,2,2017,4,0,2,1,2303,9390,11693
2017-04-20,2,2017,4,0,3,1,3306,8967,12273
2017-04-21,2,2017,4,0,4,1,4349,9192,13541
2017-04-22,2,2017,4,0,5,1,1330,3155,4485
2017-04-23,2,2017,4,0,6,0,4902,5842,10744
2017-04-24,2,2017,4,0,0,0,581,5103,5684
2017-04-25,2,2017,4,0,1,1,733,7233,7966
2017-04-26,2,2017,4,0,2,1,1881,10088,11969
2017-04-27,2,2017,4,0,3,1,2990,10797,13787
2017-04-28,2,2017,4,0,4,1,4237,10154,14391
2017-04-29,2,2017,4,0,5,1,7154,7258,14412
2017-04-30,2,2017,4,0,6,0,6724,6889,13613
2017-05-01,2,2017,5,0,0,0,2304,8678,10982
2017-05-02,2,2017,5,0,1,1,2518,10794,13312
2017-05-03,2,2017,5,0,2,1,2482,10449,12931
2017-05-04,2,2017,5,0,3,1,2195,9656,11851
2017-05-05,2,2017,5,0,4,1,1511,5752,7263
2017-05-06,2,2017,5,0,5,1,1769,4073,5842
2017-05-07,2,2017,5,0,6,0,3801,5812,9613
2017-05-08,2,2017,5,0,0,0,2330,9082,11412
2017-05-09,2,2017,5,0,1,1,2266,10103,12369
2017-05-10,2,2017,5,0,2,1,2760,10769,13529
2017-05-11,2,2017,5,0,3,1,320,3327,3647
2017-05-12,2,2017,5,0,4,1,1395,5818,7213
2017-05-13,2,2017,5,0,5,1,2843,5334,8177
2017-05-14,2,2017,5,0,6,0,6161,6705,12866
2017-05-15,2,2017,5,0,0,0,3058,9522,12580
2017-05-16,2,2017,5,0,1,1,2829,10811,13640
2017-05-17,2,2017,5,0,2,1,2480,10299,12779
2017-05-18,2,2017,5,0,3,1,2606,9798,12404
2017-05-19,2,2017,5,0,4,1,3533,9894,13427
2017-05-20,2,2017,5,0,5,1,6994,6801,13795
2017-05-21,2,2017,5,0,6,0,5096,6005,11101
2017-05-22,2,2017,5,0,0,0,2180,6926,9106
2017-05-23,2,2017,5,0,1,1,2080,8442,10522
2017-05-24,2,2017,5,0,2,1,2281,9661,11942
2017-05-25,2,2017,5,0,3,1,1167,5547,6714
2017-05-26,2,2017,5,0,4,1,4224,9367,13591
2017-05-27,2,2017,5,0,5,1,6531,4944,11475
2017-05-28,2,2017,5,0,6,0,6180,4008,10188
2017-05-29,2,2017,5,1,0,0,6971,5960,12931
2017-05-30,2,2017,5,0,1,1,2245,8058,10303
2017-05-31,2,2017,5,0,2,1,2653,9519,12172
2017-06-01,2,2017,6,0,3,1,3066,10589,13655
2017-06-02,2,2017,6,0,4,1,3798,10312,14110
2017-06-03,2,2017,6,0,5,1,6514,7384,13898
2017-06-04,2,2017,6,0,6,0,5808,6826,12634
2017-06-05,2,2017,6,0,0,0,2026,8614,10640
2017-06-06,2,2017,6,0,1,1,3125,11014,14139
2017-06-07,2,2017,6,0,2,1,2223,10339,12562
2017-06-08,2,2017,6,0,3,1,3234,10718,13952
2017-06-09,2,2017,6,0,4,1,4290,10285,14575
2017-06-10,2,2017,6,0,5,1,7360,7317,14677
2017-06-11,2,2017,6,0,6,0,5248,6587,11835
2017-06-12,2,2017,6,0,0,0,2901,9404,12305
2017-06-13,2,2017,6,0,1,1,2636,9898,12534
2017-06-14,2,2017,6,0,2,1,2820,10387,13207
2017-06-15,2,2017,6,0,3,1,3447,10396,13843
2017-06-16,2,2017,6,0,4,1,3285,9180,12465
2017-06-17,2,2017,6,0,5,1,6206,6987,13193
2017-06-18,2,2017,6,0,6,0,5131,6030,11161
2017-06-19,2,2017,6,0,0,0,2298,7125,9423
2017-06-20,2,2017,6,0,1,1,3173,10804,13977
2017-06-21,3,2017,6,0,2,1,2968,11042,14010
2017-06-22,3,2017,6,0,3,1,3127,10372,13499
2017-06-23,3,2017,6,0,4,1,3286,9232,12518
2017-06-24,3,2017,6,0,5,1,6915,7406,14321
2017-06-25,3,2017,6,0,6,0,6402,7219,13621
2017-06-26,3,2017,6,0,0,0,3842,10550,14392
2017-06-27,3,2017,6,0,1,1,3532,11483,15015
2017-06-28,3,2017,6,0,2,1,3416,11477,14893
2017-06-29,3,2017,6,0,3,1,3168,10777,13945
2017-06-30,3,2017,6,0,4,1,3783,9969,13752
2017-07-01,3,2017,7,0,5,1,5698,5711,11409
2017-07-02,3,2017,7,0,6,0,7750,5833,13583
2017-07-03,3,2017,7,0,0,0,7025,8268,15293
2017-07-04,3,2017,7,1,1,0,8612,6791,15403
2017-07-05,3,2017,7,0,2,1,2959,7628,10587
2017-07-06,3,2017,7,0,3,1,1433,5924,7357
2017-07-07,3,2017,7,0,4,1,3979,10002,13981
2017-07-08,3,2017,7,0,5,1,7472,8045,15517
2017-07-09,3,2017,7,0,6,0,7554,7748,15302
2017-07-10,3,2017,7,0,0,0,3153,9766,12919
2017-07-11,3,2017,7,0,1,1,3197,10479,13676
2017-07-12,3,2017,7,0,2,1,3220,10265,13485
2017-07-13,3,2017,7,0,3,1,3013,9646,12659
2017-07-14,3,2017,7,0,4,1,2838,7474,10312
2017-07-15,3,2017,7,0,5,1,7074,7395,14469
2017-07-16,3,2017,7,0,6,0,6446,7138,13584
2017-07-17,3,2017,7,0,0,0,3192,9286,12478
2017-07-18,3,2017,7,0,1,1,3064,9858,12922
2017-07-19,3,2017,7,0,2,1,2761,10405,13166
2017-07-20,3,2017,7,0,3,1,2911,9762,12673
2017-07-21,3,2017,7,0,4,1,3795,9144,12939
2017-07-22,3,2017,7,0,5,1,4570,5458,10028
2017-07-23,3,2017,7,0,6,0,4979,6071,11050
2017-07-24,3,2017,7,0,0,0,3291,9228,12519
2017-07-25,3,2017,7,0,1,1,3790,11184,14974
2017-07-26,3,2017,7,0,2,1,3954,11595,15549
2017-07-27,3,2017,7,0,3,1,3934,10718,14652
2017-07-28,3,2017,7,0,4,1,1129,4597,5726
2017-07-29,3,2017,7,0,5,1,4079,5686,9765
2017-07-30,3,2017,7,0,6,0,7793,7974,15767
2017-07-31,3,2017,7,0,0,0,4096,9840,13936
2017-08-01,3,2017,8,0,1,1,2907,9495,12402
2017-08-02,3,2017,8,0,2,1,3333,10746,14079
2017-08-03,3,2017,8,0,3,1,3125,9671,12796
2017-08-04,3,2017,8,0,4,1,4317,9971,14288
2017-08-05,3,2017,8,0,5,1,8358,7988,16346
2017-08-06,3,2017,8,0,6,0,7173,6986,14159
2017-08-07,3,2017,8,0,0,0,926,4969,5895
2017-08-08,3,2017,8,0,1,1,3888,10854,14742
2017-08-09,3,2017,8,0,2,1,3946,11016,14962
2017-08-10,3,2017,8,0,3,1,4057,10722,14779
2017-08-11,3,2017,8,0,4,1,3383,9006,12389
2017-08-12,3,2017,8,0,5,1,5521,6171,11692
2017-08-13,3,2017,8,0,6,0,6791,7355,14146
2017-08-14,3,2017,8,0,0,0,3720,9460,13180
2017-08-15,3,2017,8,0,1,1,1918,8035,9953
2017-08-16,3,2017,8,0,2,1,3079,10498,13577
2017-08-17,3,2017,8,0,3,1,3094,10207,13301
2017-08-18,3,2017,8,0,4,1,2998,8405,11403
2017-08-19,3,2017,8,0,5,1,6170,7272,13442
2017-08-20,3,2017,8,0,6,0,5512,7131,12643
2017-08-21,3,2017,8,0,0,0,3096,9175,12271
2017-08-22,3,2017,8,0,1,1,2688,9915,12603
2017-08-23,3,2017,8,0,2,1,3242,10819,14061
2017-08-24,3,2017,8,0,3,1,3242,10892,14134
2017-08-25,3,2017,8,0,4,1,3958,10924,14882
2017-08-26,3,2017,8,0,5,1,6549,8130,14679
2017-08-27,3,2017,8,0,6,0,5745,7611,13356
2017-08-28,3,2017,8,0,0,0,2884,10245,13129
2017-08-29,3,2017,8,0,1,1,562,4058,4620
2017-08-30,3,2017,8,0,2,1,2884,11830,14714
2017-08-31,3,2017,8,0,3,1,2781,11130,13911
2017-09-01,3,2017,9,0,4,1,3359,9817,13176
2017-09-02,3,2017,9,0,5,1,1321,2854,4175
2017-09-03,3,2017,9,0,6,0,8860,6511,15371
2017-09-04,3,2017,9,1,0,0,6433,7147,13580
2017-09-05,3,2017,9,0,1,1,2069,9290,11359
2017-09-06,3,2017,9,0,2,1,443,5553,5996
2017-09-07,3,2017,9,0,3,1,2289,11761,14050
2017-09-08,3,2017,9,0,4,1,3245,11446,14691
2017-09-09,3,2017,9,0,5,1,6216,8546,14762
2017-09-10,3,2017,9,0,6,0,5188,7821,13009
2017-09-11,3,2017,9,0,0,0,2982,10419,13401
2017-09-12,3,2017,9,0,1,1,2741,11756,14497
2017-09-13,3,2017,9,0,2,1,2116,9804,11920
2017-09-14,3,2017,9,0,3,1,2257,10962,13219
2017-09-15,3,2017,9,0,4,1,3421,11183,14604
2017-09-16,3,2017,9,0,5,1,6589,8708,15297
2017-09-17,3,2017,9,0,6,0,5435,7734,13169
2017-09-18,3,2017,9,0,0,0,2632,10402,13034
2017-09-19,3,2017,9,0,1,1,2428,11617,14045
2017-09-20,3,2017,9,0,2,1,2355,11365,13720
2017-09-21,3,2017,9,0,3,1,2338,11143,13481
2017-09-22,3,2017,9,0,4,1,3301,10739,14040
2017-09-23,4,2017,9,0,5,1,5400,8084,13484
2017-09-24,4,2017,9,0,6,0,4863,7110,11973
2017-09-25,4,2017,9,0,0,0,2391,10262,12653
2017-09-26,4,2017,9,0,1,1,2041,11416,13457
2017-09-27,4,2017,9,0,2,1,2063,11218,13281
2017-09-28,4,2017,9,0,3,1,2528,11848,14376
2017-09-29,4,2017,9,0,4,1,3346,11184,14530
2017-09-30,4,2017,9,0,5,1,5132,7889,13021
2017-10-01,4,2017,10,0,6,0,4547,7455,12002
2017-10-02,4,2017,10,0,0,0,2096,10604,12700
2017-10-03,4,2017,10,0,1,1,2087,11397,13484
2017-10-04,4,2017,10,0,2,1,2087,11657,13744
2017-10-05,4,2017,10,0,3,1,2330,11562,13892
2017-10-06,4,2017,10,0,4,1,3797,11188,14985
2017-10-07,4,2017,10,0,5,1,7262,8215,15477
2017-10-08,4,2017,10,0,6,0,4501,5903,10404
2017-10-09,4,2017,10,1,0,0,2571,6459,9030
2017-10-10,4,2017,10,0,1,1,2678,10475,13153
2017-10-11,4,2017,10,0,2,1,1390,8984,10374
2017-10-12,4,2017,10,0,3,1,1788,9942,11730
2017-10-13,4,2017,10,0,4,1,2597,9772,12369
2017-10-14,4,2017,10,0,5,1,5572,8243,13815
2017-10-15,4,2017,10,0,6,0,4814,7514,12328
2017-10-16,4,2017,10,0,0,0,1985,9820,11805
2017-10-17,4,2017,10,0,1,1,1645,10641,12286
2017-10-18,4,2017,10,0,2,1,2023,10982,13005
2017-10-19,4,2017,10,0,3,1,2365,10949,13314
2017-10-20,4,2017,10,0,4,1,3343,10904,14247
2017-10-21,4,2017,10,0,5,1,6158,8306,14464
2017-10-22,4,2017,10,0,6,0,5571,7813,13384
2017-10-23,4,2017,10,0,0,0,2619,9983,12602
2017-10-24,4,2017,10,0,1,1,2148,11001,13149
2017-10-25,4,2017,10,0,2,1,1786,11035,12821
2017-10-26,4,2017,10,0,3,1,1578,10190,11768
2017-10-27,4,2017,10,0,4,1,2862,10287,13149
2017-10-28,4,2017,10,0,5,1,5483,7538,13021
2017-10-29,4,2017,10,0,6,0,1241,3350,4591
2017-10-30,4,2017,10,0,0,0,1461,8694,10155
2017-10-31,4,2017,10,0,1,1,1494,10091,11585
2017-11-01,4,2017,11,0,2,1,1094,9765,10859
2017-11-02,4,2017,11,0,3,1,1883,11042,12925
2017-11-03,4,2017,11,0,4,1,3092,10685,13777
2017-11-04,4,2017,11,0,5,1,3537,5741,9278
2017-11-05,4,2017,11,0,6,0,1590,4296,5886
2017-11-06,4,2017,11,0,0,0,1518,9498,11016
2017-11-07,4,2017,11,0,1,1,247,4865,5112
2017-11-08,4,2017,11,0,2,1,700,8554,9254
2017-11-09,4,2017,11,0,3,1,1014,8587,9601
2017-11-10,4,2017,11,1,4,0,1029,5726,6755
2017-11-11,4,2017,11,1,5,0,1448,4046,5494
2017-11-12,4,2017,11,0,6,0,1477,4220,5697
2017-11-13,4,2017,11,0,0,0,1032,8028,9060
2017-11-14,4,2017,11,0,1,1,807,8687,9494
2017-11-15,4,2017,11,0,2,1,808,8977,9785
2017-11-16,4,2017,11,0,3,1,1143,9057,10200
2017-11-17,4,2017,11,0,4,1,1312,8229,9541
2017-11-18,4,2017,11,0,5,1,2436,5319,7755
2017-11-19,4,2017,11,0,6,0,1425,4486,5911
2017-11-20,4,2017,11,0,0,0,1009,7626,8635
2017-11-21,4,2017,11,0,1,1,1220,8158,9378
2017-11-22,4,2017,11,0,2,1,965,6243,7208
2017-11-23,4,2017,11,1,3,0,1266,1841,3107
2017-11-24,4,2017,11,0,4,1,2265,3118,5383
2017-11-25,4,2017,11,0,5,1,3195,3982,7177
2017-11-26,4,2017,11,0,6,0,1342,3901,5243
2017-11-27,4,2017,11,0,0,0,846,8154,9000
2017-11-28,4,2017,11,0,1,1,795,8881,9676
2017-11-29,4,2017,11,0,2,1,874,9285,10159
2017-11-30,4,2017,11,0,3,1,942,9226,10168
2017-12-01,4,2017,12,0,4,1,1094,8565,9659
2017-12-02,4,2017,12,0,5,1,1930,5630,7560
2017-12-03,4,2017,12,0,6,0,1628,5081,6709
2017-12-04,4,2017,12,0,0,0,721,8164,8885
2017-12-05,4,2017,12,0,1,1,600,7692,8292
2017-12-06,4,2017,12,0,2,1,513,8028,8541
2017-12-07,4,2017,12,0,3,1,685,8036,8721
2017-12-08,4,2017,12,0,4,1,693,7188,7881
2017-12-09,4,2017,12,0,5,1,184,2162,2346
2017-12-10,4,2017,12,0,6,0,579,3572,4151
2017-12-11,4,2017,12,0,0,0,497,7374,7871
2017-12-12,4,2017,12,0,1,1,464,7261,7725
2017-12-13,4,2017,12,0,2,1,222,5632,5854
2017-12-14,4,2017,12,0,3,1,343,6749,7092
2017-12-15,4,2017,12,0,4,1,198,4767,4965
2017-12-16,4,2017,12,0,5,1,931,4253,5184
2017-12-17,4,2017,12,0,6,0,968,4173,5141
2017-12-18,4,2017,12,0,0,0,1049,7929,8978
2017-12-19,4,2017,12,0,1,1,1250,8670,9920
2017-12-20,4,2017,12,0,2,1,818,7518,8336
2017-12-21,1,2017,12,0,3,1,683,6321,7004
2017-12-22,1,2017,12,0,4,1,963,5196,6159
2017-12-23,1,2017,12,0,5,1,559,1905,2464
2017-12-24,1,2017,12,0,6,0,469,1572,2041
2017-12-25,1,2017,12,1,0,0,328,713,1041
2017-12-26,1,2017,12,0,1,1,404,2385,2789
2017-12-27,1,2017,12,0,2,1,387,2934,3321
2017-12-28,1,2017,12,0,3,1,248,2618,2866
2017-12-29,1,2017,12,0,4,1,344,2744,3088
2017-12-30,1,2017,12,0,5,1,243,1633,1876
2017-12-31,1,2017,12,0,6,0,116,1321,1437
2018-01-01,1,2018,1,1,0,0,145,1068,1213
2018-01-02,1,2018,1,0,1,1,179,3613,3792
2018-01-03,1,2018,1,0,2,1,279,4469,4748
2018-01-04,1,2018,1,0,3,1,66,2302,2368
2018-01-05,1,2018,1,0,4,1,62,2647,2709
2018-01-06,1,2018,1,0,5,1,52,1437,1489
2018-01-07,1,2018,1,0,6,0,126,1627,1753
2018-01-08,1,2018,1,0,0,0,174,3906,4080
2018-01-09,1,2018,1,0,1,1,392,5732,6124
2018-01-10,1,2018,1,0,2,1,510,6591,7101
2018-01-11,1,2018,1,0,3,1,679,7531,8210
2018-01-12,1,2018,1,0,4,1,566,5284,5850
2018-01-13,1,2018,1,0,5,1,559,2819,3378
2018-01-14,1,2018,1,0,6,0,272,2068,2340
2018-01-15,1,2018,1,1,0,0,332,2991,3323
2018-01-16,1,2018,1,0,1,1,384,6452,6836
2018-01-17,1,2018,1,0,2,1,124,3984,4108
2018-01-18,1,2018,1,0,3,1,326,5871,6197
2018-01-19,1,2018,1,0,4,1,794,6810,7604
2018-01-20,1,2018,1,0,5,1,2284,5749,8033
2018-01-21,1,2018,1,0,6,0,1572,4970,6542
2018-01-22,1,2018,1,0,0,0,913,8472,9385
2018-01-23,1,2018,1,0,1,1,612,7588,8200
2018-01-24,1,2018,1,0,2,1,378,7350,7728
2018-01-25,1,2018,1,0,3,1,366,6730,7096
2018-01-26,1,2018,1,0,4,1,636,6658,7294
2018-01-27,1,2018,1,0,5,1,2863,5844,8707
2018-01-28,1,2018,1,0,6,0,387,2480,2867
2018-01-29,1,2018,1,0,0,0,407,6858,7265
2018-01-30,1,2018,1,0,1,1,234,5629,5863
2018-01-31,1,2018,1,0,2,1,326,6061,6387
2018-02-01,1,2018,2,0,3,1,412,7320,7732
2018-02-02,1,2018,2,0,4,1,225,4974,5199
2018-02-03,1,2018,2,0,5,1,551,3243,3794
2018-02-04,1,2018,2,0,6,0,100,1328,1428
2018-02-05,1,2018,2,0,0,0,281,5614,5895
2018-02-06,1,2018,2,0,1,1,304,6552,6856
2018-02-07,1,2018,2,0,2,1,102,4137,4239
2018-02-08,1,2018,2,0,3,1,289,6236,6525
2018-02-09,1,2018,2,0,4,1,639,6374,7013
2018-02-10,1,2018,2,0,5,1,279,1818,2097
2018-02-11,1,2018,2,0,6,0,648,2688,3336
2018-02-12,1,2018,2,0,0,0,557,6300,6857
2018-02-13,1,2018,2,0,1,1,406,6829,7235
2018-02-14,1,2018,2,0,2,1,584,7456,8040
2018-02-15,1,2018,2,0,3,1,1194,8565,9759
2018-02-16,1,2018,2,0,4,1,808,6114,6922
2018-02-17,1,2018,2,0,5,1,696,2425,3121
2018-02-18,1,2018,2,0,6,0,2909,4048,6957
2018-02-19,1,2018,2,1,0,0,814,3767,4581
2018-02-20,1,2018,2,0,1,1,1869,9120,10989
2018-02-21,1,2018,2,0,2,1,1990,9816,11806
2018-02-22,1,2018,2,0,3,1,657,6637,7294
2018-02-23,1,2018,2,0,4,1,818,6063,6881
2018-02-24,1,2018,2,0,5,1,1218,4189,5407
2018-02-25,1,2018,2,0,6,0,899,3655,4554
2018-02-26,1,2018,2,0,0,0,693,7772,8465
2018-02-27,1,2018,2,0,1,1,959,8727,9686
2018-02-28,1,2018,2,0,2,1,932,8778,9710
2018-03-01,1,2018,3,0,3,1,572,7242,7814
2018-03-02,1,2018,3,0,4,1,266,2901,3167
2018-03-03,1,2018,3,0,5,1,1471,4243,5714
2018-03-04,1,2018,3,0,6,0,1985,4528,6513
2018-03-05,1,2018,3,0,0,0,1003,6696,7699
2018-03-06,1,2018,3,0,1,1,536,6607,7143
2018-03-07,1,2018,3,0,2,1,472,6141,6613
2018-03-08,1,2018,3,0,3,1,673,7104,7777
2018-03-09,1,2018,3,0,4,1,780,6455,7235
2018-03-10,1,2018,3,0,5,1,2867,5428,8295
2018-03-11,1,2018,3,0,6,0,2985,4759,7744
2018-03-12,1,2018,3,0,0,0,838,6448,7286
2018-03-13,1,2018,3,0,1,1,846,6598,7444
2018-03-14,1,2018,3,0,2,1,531,6335,6866
2018-03-15,1,2018,3,0,3,1,1225,7266,8491
2018-03-16,1,2018,3,0,4,1,1049,6284,7333
2018-03-17,1,2018,3,0,5,1,1577,4068,5645
2018-03-18,1,2018,3,0,6,0,3891,5652,9543
2018-03-19,1,2018,3,0,0,0,1749,7810,9559
2018-03-20,1,2018,3,0,1,1,70,2070,2140
2018-03-21,2,2018,3,0,2,1,59,1239,1298
2018-03-22,2,2018,3,0,3,1,555,6073,6628
2018-03-23,2,2018,3,0,4,1,1425,7097,8522
2018-03-24,2,2018,3,0,5,1,3554,6592,10146
2018-03-25,2,2018,3,0,6,0,2291,4556,6847
2018-03-26,2,2018,3,0,0,0,2115,7360,9475
2018-03-27,2,2018,3,0,1,1,1151,6825,7976
2018-03-28,2,2018,3,0,2,1,1465,5951,7416
2018-03-29,2,2018,3,0,3,1,4127,9555,13682
2018-03-30,2,2018,3,0,4,1,3541,7572,11113
2018-03-31,2,2018,3,0,5,1,8550,7324,15874
2018-04-01,2,2018,4,0,6,0,5077,5391,10468
2018-04-02,2,2018,4,0,0,0,1890,7512,9402
2018-04-03,2,2018,4,0,1,1,1531,7695,9226
2018-04-04,2,2018,4,0,2,1,1618,8291,9909
2018-04-05,2,2018,4,0,3,1,2697,9043,11740
2018-04-06,2,2018,4,0,4,1,4885,10045,14930
2018-04-07,2,2018,4,0,5,1,2256,5325,7581
2018-04-08,2,2018,4,0,6,0,3921,6238,10159
2018-04-09,2,2018,4,0,0,0,1100,6946,8046
2018-04-10,2,2018,4,0,1,1,1759,8749,10508
2018-04-11,2,2018,4,0,2,1,1781,9382,11163
2018-04-12,2,2018,4,0,3,1,2761,10325,13086
2018-04-13,2,2018,4,0,4,1,5124,10972,16096
2018-04-14,2,2018,4,0,5,1,10039,9074,19113
2018-04-15,2,2018,4,0,6,0,1494,3361,4855
2018-04-16,2,2018,4,0,0,0,706,5815,6521
2018-04-17,2,2018,4,0,1,1,920,8079,8999
2018-04-18,2,2018,4,0,2,1,1828,9567,11395
2018-04-19,2,2018,4,0,3,1,1082,7610,8692
2018-04-20,2,2018,4,0,4,1,2347,9220,11567
2018-04-21,2,2018,4,0,5,1,6183,7857,14040
2018-04-22,2,2018,4,0,6,0,5836,7166,13002
2018-04-23,2,2018,4,0,0,0,2582,9234,11816
2018-04-24,2,2018,4,0,1,1,827,6250,7077
2018-04-25,2,2018,4,0,2,1,1242,7932,9174
2018-04-26,2,2018,4,0,3,1,3144,10797,13941
2018-04-27,2,2018,4,0,4,1,2534,7792,10326
2018-04-28,2,2018,4,0,5,1,6867,8034,14901
2018-04-29,2,2018,4,0,6,0,3066,5774,8840
2018-04-30,2,2018,4,0,0,0,2505,9829,12334
2018-05-01,2,2018,5,0,1,1,2913,11214,14127
2018-05-02,2,2018,5,0,2,1,2736,11196,13932
2018-05-03,2,2018,5,0,3,1,2957,11206,14163
2018-05-04,2,2018,5,0,4,1,4044,10076,14120
2018-05-05,2,2018,5,0,5,1,4783,7469,12252
2018-05-06,2,2018,5,0,6,0,4518,6894,11412
2018-05-07,2,2018,5,0,0,0,3319,10503,13822
2018-05-08,2,2018,5,0,1,1,2622,11235,13857
2018-05-09,2,2018,5,0,2,1,2709,11348,14057
2018-05-10,2,2018,5,0,3,1,2649,10399,13048
2018-05-11,2,2018,5,0,4,1,4184,10845,15029
2018-05-12,2,2018,5,0,5,1,6114,8113,14227
2018-05-13,2,2018,5,0,6,0,3081,5175,8256
2018-05-14,2,2018,5,0,0,0,2481,8378,10859
2018-05-15,2,2018,5,0,1,1,2672,9782,12454
2018-05-16,2,2018,5,0,2,1,918,6058,6976
2018-05-17,2,2018,5,0,3,1,510,4285,4795
2018-05-18,2,2018,5,0,4,1,471,4305,4776
2018-05-19,2,2018,5,0,5,1,2044,4754,6798
2018-05-20,2,2018,5,0,6,0,5929,8151,14080
2018-05-21,2,2018,5,0,0,0,3559,11068,14627
2018-05-22,2,2018,5,0,1,1,1422,7205,8627
2018-05-23,2,2018,5,0,2,1,3042,11526,14568
2018-05-24,2,2018,5,0,3,1,3353,11115,14468
2018-05-25,2,2018,5,0,4,1,4417,10408,14825
2018-05-26,2,2018,5,0,5,1,5989,6625,12614
2018-05-27,2,2018,5,0,6,0,6627,6347,12974
2018-05-28,2,2018,5,1,0,0,5276,6862,12138
2018-05-29,2,2018,5,0,1,1,2962,10379,13341
2018-05-30,2,2018,5,0,2,1,2344,10419,12763
2018-05-31,2,2018,5,0,3,1,1658,8472,10130
2018-06-01,2,2018,6,0,4,1,3418,10599,14017
2018-06-02,2,2018,6,0,5,1,4076,7092,11168
2018-06-03,2,2018,6,0,6,0,451,1652,2103
2018-06-04,2,2018,6,0,0,0,3666,11097,14763
2018-06-05,2,2018,6,0,1,1,2673,11472,14145
2018-06-06,2,2018,6,0,2,1,2973,11928,14901
2018-06-07,2,2018,6,0,3,1,3590,12116,15706
2018-06-08,2,2018,6,0,4,1,4360,11198,15558
2018-06-09,2,2018,6,0,5,1,5568,8141,13709
2018-06-10,2,2018,6,0,6,0,4611,7331,11942
2018-06-11,2,2018,6,0,0,0,2123,8688,10811
2018-06-12,2,2018,6,0,1,1,3629,12189,15818
2018-06-13,2,2018,6,0,2,1,3077,11650,14727
2018-06-14,2,2018,6,0,3,1,3539,11833,15372
2018-06-15,2,2018,6,0,4,1,4317,11500,15817
2018-06-16,2,2018,6,0,5,1,6391,8794,15185
2018-06-17,2,2018,6,0,6,0,4712,7351,12063
2018-06-18,2,2018,6,0,0,0,2783,9772,12555
2018-06-19,2,2018,6,0,1,1,2059,9976,12035
2018-06-20,2,2018,6,0,2,1,2102,9859,11961
2018-06-21,3,2018,6,0,3,1,3001,10895,13896
2018-06-22,3,2018,6,0,4,1,994,5544,6538
2018-06-23,3,2018,6,0,5,1,3915,7275,11190
2018-06-24,3,2018,6,0,6,0,4821,7744,12565
2018-06-25,3,2018,6,0,0,0,3138,11009,14147
2018-06-26,3,2018,6,0,1,1,3025,11749,14774
2018-06-27,3,2018,6,0,2,1,2380,10537,12917
2018-06-28,3,2018,6,0,3,1,3065,11771,14836
2018-06-29,3,2018,6,0,4,1,3582,10455,14037
2018-06-30,3,2018,6,0,5,1,4976,8106,13082
2018-07-01,3,2018,7,0,6,0,3784,6677,10461
2018-07-02,3,2018,7,0,0,0,2696,9146,11842
2018-07-03,3,2018,7,0,1,1,3061,9733,12794
2018-07-04,3,2018,7,1,2,0,6326,8359,14685
2018-07-05,3,2018,7,0,3,1,4025,10199,14224
2018-07-06,3,2018,7,0,4,1,4246,10059,14305
2018-07-07,3,2018,7,0,5,1,7089,9977,17066
2018-07-08,3,2018,7,0,6,0,5897,9050,14947
2018-07-09,3,2018,7,0,0,0,3250,11056,14306
2018-07-10,3,2018,7,0,1,1,2443,11096,13539
2018-07-11,3,2018,7,0,2,1,3041,11293,14334
2018-07-12,3,2018,7,0,3,1,3184,11712,14896
2018-07-13,3,2018,7,0,4,1,3547,11703,15250
2018-07-14,3,2018,7,0,5,1,6461,9294,15755
2018-07-15,3,2018,7,0,6,0,4870,8240,13110
2018-07-16,3,2018,7,0,0,0,2870,10269,13139
2018-07-17,3,2018,7,0,1,1,1954,9993,11947
2018-07-18,3,2018,7,0,2,1,3058,12266,15324
2018-07-19,3,2018,7,0,3,1,3345,11867,15212
2018-07-20,3,2018,7,0,4,1,4330,11683,16013
2018-07-21,3,2018,7,0,5,1,759,2035,2794
2018-07-22,3,2018,7,0,6,0,2655,5571,8226
2018-07-23,3,2018,7,0,0,0,2175,8186,10361
2018-07-24,3,2018,7,0,1,1,1216,6364,7580
2018-07-25,3,2018,7,0,2,1,1564,8097,9661
2018-07-26,3,2018,7,0,3,1,3150,11690,14840
2018-07-27,3,2018,7,0,4,1,3154,10378,13532
2018-07-28,3,2018,7,0,5,1,6343,9666,16009
2018-07-29,3,2018,7,0,6,0,5998,8890,14888
2018-07-30,3,2018,7,0,0,0,2411,7824,10235
2018-07-31,3,2018,7,0,1,1,2570,10916,13486
2018-08-01,3,2018,8,0,2,1,2856,11343,14199
2018-08-02,3,2018,8,0,3,1,2221,9637,11858
2018-08-03,3,2018,8,0,4,1,2590,8742,11332
2018-08-04,3,2018,8,0,5,1,5994,9017,15011
2018-08-05,3,2018,8,0,6,0,5142,7786,12928
2018-08-06,3,2018,8,0,0,0,3184,9876,13060
2018-08-07,3,2018,8,0,1,1,2536,10127,12663
2018-08-08,3,2018,8,0,2,1,2580,10962,13542
2018-08-09,3,2018,8,0,3,1,3032,11233,14265
2018-08-10,3,2018,8,0,4,1,3407,10531,13938
2018-08-11,3,2018,8,0,5,1,4724,7753,12477
2018-08-12,3,2018,8,0,6,0,3498,6504,10002
2018-08-13,3,2018,8,0,0,0,2827,9976,12803
2018-08-14,3,2018,8,0,1,1,2781,11629,14410
2018-08-15,3,2018,8,0,2,1,2848,11644,14492
2018-08-16,3,2018,8,0,3,1,2672,11149,13821
2018-08-17,3,2018,8,0,4,1,2685,10049,12734
2018-08-18,3,2018,8,0,5,1,5280,8695,13975
2018-08-19,3,2018,8,0,6,0,4429,8391,12820
2018-08-20,3,2018,8,0,0,0,2830,10322,13152
2018-08-21,3,2018,8,0,1,1,1102,8658,9760
2018-08-22,3,2018,8,0,2,1,2426,11673,14099
2018-08-23,3,2018,8,0,3,1,2717,12464,15181
2018-08-24,3,2018,8,0,4,1,3066,11837,14903
2018-08-25,3,2018,8,0,5,1,4971,9689,14660
2018-08-26,3,2018,8,0,6,0,4264,8156,12420
2018-08-27,3,2018,8,0,0,0,1806,10098,11904
2018-08-28,3,2018,8,0,1,1,1856,10290,12146
2018-08-29,3,2018,8,0,2,1,1545,10373,11918
2018-08-30,3,2018,8,0,3,1,1628,10162,11790
2018-08-31,3,2018,8,0,4,1,2061,9542,11603
2018-09-01,3,2018,9,0,5,1,4083,6749,10832
2018-09-02,3,2018,9,0,6,0,5892,8339,14231
2018-09-03,3,2018,9,1,0,0,3730,7076,10806
2018-09-04,3,2018,9,0,1,1,1351,9574,10925
2018-09-05,3,2018,9,0,2,1,1415,11145,12560
2018-09-06,3,2018,9,0,3,1,1548,11138,12686
2018-09-07,3,2018,9,0,4,1,1323,8094,9417
2018-09-08,3,2018,9,0,5,1,1781,6165,7946
2018-09-09,3,2018,9,0,6,0,422,2378,2800
2018-09-10,3,2018,9,0,0,0,1146,8822,9968
2018-09-11,3,2018,9,0,1,1,1475,10629,12104
2018-09-12,3,2018,9,0,2,1,1425,10957,12382
2018-09-13,3,2018,9,0,3,1,1498,11083,12581
2018-09-14,3,2018,9,0,4,1,1884,10980,12864
2018-09-15,3,2018,9,0,5,1,3835,9506,13341
2018-09-16,3,2018,9,0,6,0,3198,8710,11908
2018-09-17,3,2018,9,0,0,0,559,6385,6944
2018-09-18,3,2018,9,0,1,1,1036,9589,10625
2018-09-19,3,2018,9,0,2,1,1805,11895,13700
2018-09-20,3,2018,9,0,3,1,1919,11700,13619
2018-09-21,3,2018,9,0,4,1,2120,10594,12714
2018-09-22,3,2018,9,0,5,1,4138,9687,13825
2018-09-23,4,2018,9,0,6,0,446,2340,2786
2018-09-24,4,2018,9,0,0,0,490,5841,6331
2018-09-25,4,2018,9,0,1,1,923,9352,10275
2018-09-26,4,2018,9,0,2,1,1194,10006,11200
2018-09-27,4,2018,9,0,3,1,579,6176,6755
2018-09-28,4,2018,9,0,4,1,2120,10889,13009
2018-09-29,4,2018,9,0,5,1,4551,10050,14601
2018-09-30,4,2018,9,0,6,0,3445,8620,12065
2018-10-01,4,2018,10,0,0,0,1572,10937,12509
2018-10-02,4,2018,10,0,1,1,1737,11906,13643
2018-10-03,4,2018,10,0,2,1,1587,12143,13730
2018-10-04,4,2018,10,0,3,1,1584,11715,13299
2018-10-05,4,2018,10,0,4,1,2166,11407,13573
2018-10-06,4,2018,10,0,5,1,4164,9137,13301
2018-10-07,4,2018,10,0,6,0,4517,9017,13534
2018-10-08,4,2018,10,1,0,0,2882,9483,12365
2018-10-09,4,2018,10,0,1,1,1658,10591,12249
2018-10-10,4,2018,10,0,2,1,1616,11457,13073
2018-10-11,4,2018,10,0,3,1,648,6324,6972
2018-10-12,4,2018,10,0,4,1,2221,11000,13221
2018-10-13,4,2018,10,0,5,1,2997,8293,11290
2018-10-14,4,2018,10,0,6,0,1931,6108,8039
2018-10-15,4,2018,10,0,0,0,959,7562,8521
2018-10-16,4,2018,10,0,1,1,1128,10613,11741
2018-10-17,4,2018,10,0,2,1,1368,11275,12643
2018-10-18,4,2018,10,0,3,1,1325,10254,11579
2018-10-19,4,2018,10,0,4,1,1812,10148,11960
2018-10-20,4,2018,10,0,5,1,3166,8224,11390
2018-10-21,4,2018,10,0,6,0,1691,6015,7706
2018-10-22,4,2018,10,0,0,0,1199,9002,10201
2018-10-23,4,2018,10,0,1,1,1180,10552,11732
2018-10-24,4,2018,10,0,2,1,986,10015,11001
2018-10-25,4,2018,10,0,3,1,1044,9296,10340
2018-10-26,4,2018,10,0,4,1,738,6742,7480
2018-10-27,4,2018,10,0,5,1,774,3950,4724
2018-10-28,4,2018,10,0,6,0,2039,6541,8580
2018-10-29,4,2018,10,0,0,0,931,8935,9866
2018-10-30,4,2018,10,0,1,1,966,10398,11364
2018-10-31,4,2018,10,0,2,1,1038,10357,11395
2018-11-01,4,2018,11,0,3,1,1328,11104,12432
2018-11-02,4,2018,11,0,4,1,1254,8851,10105
2018-11-03,4,2018,11,0,5,1,2372,6912,9284
2018-11-04,4,2018,11,0,6,0,2231,6853,9084
2018-11-05,4,2018,11,0,0,0,306,4093,4399
2018-11-06,4,2018,11,0,1,1,298,5725,6023
2018-11-07,4,2018,11,0,2,1,746,9172,9918
2018-11-08,4,2018,11,0,3,1,884,9536,10420
2018-11-09,4,2018,11,0,4,1,418,5012,5430
2018-11-10,4,2018,11,0,5,1,1120,4962,6082
2018-11-11,4,2018,11,1,6,0,1282,5038,6320
2018-11-12,4,2018,11,1,0,0,678,4768,5446
2018-11-13,4,2018,11,0,1,1,364,6500,6864
2018-11-14,4,2018,11,0,2,1,433,7616,8049
2018-11-15,4,2018,11,0,3,1,55,2100,2155
2018-11-16,4,2018,11,0,4,1,577,7125,7702
2018-11-17,4,2018,11,0,5,1,1461,5702,7163
2018-11-18,4,2018,11,0,6,0,1209,5243,6452
2018-11-19,4,2018,11,0,0,0,911,8163,9074
2018-11-20,4,2018,11,0,1,1,699,7655,8354
2018-11-21,4,2018,11,0,2,1,779,5966,6745
2018-11-22,4,2018,11,1,3,0,352,1581,1933
2018-11-23,4,2018,11,0,4,1,504,2247,2751
2018-11-24,4,2018,11,0,5,1,153,1346,1499
2018-11-25,4,2018,11,0,6,0,1340,4947,6287
2018-11-26,4,2018,11,0,0,0,261,5548,5809
2018-11-27,4,2018,11,0,1,1,241,6370,6611
2018-11-28,4,2018,11,0,2,1,186,5954,6140
2018-11-29,4,2018,11,0,3,1,287,6542,6829
2018-11-30,4,2018,11,0,4,1,448,6568,7016
2018-12-01,4,2018,12,0,5,1,378,2857,3235
2018-12-02,4,2018,12,0,6,0,550,4283,4833
2018-12-03,4,2018,12,0,0,0,467,7709,8176
2018-12-04,4,2018,12,0,1,1,68,2369,2437
2018-12-01,4,2018,12,0,5,1,378,2857,3235
2018-12-02,4,2018,12,0,6,0,550,4283,4833
2018-12-03,4,2018,12,0,0,0,468,7710,8178
2018-12-04,4,2018,12,0,1,1,316,6726,7042
2018-12-05,4,2018,12,0,2,1,406,6100,6506
2018-12-06,4,2018,12,0,3,1,326,6626,6952
2018-12-07,4,2018,12,0,4,1,327,6239,6566
2018-12-08,4,2018,12,0,5,1,486,3934,4420
2018-12-09,4,2018,12,0,6,0,344,3203,3547
2018-12-10,4,2018,12,0,0,0,267,5838,6105
2018-12-11,4,2018,12,0,1,1,399,6596,6995
2018-12-12,4,2018,12,0,2,1,422,7152,7574
2018-12-13,4,2018,12,0,3,1,511,7694,8205
2018-12-14,4,2018,12,0,4,1,407,6009,6416
2018-12-15,4,2018,12,0,5,1,94,1114,1208
2018-12-16,4,2018,12,0,6,0,173,2190,2363
2018-12-17,4,2018,12,0,0,0,614,7158,7772
2018-12-18,4,2018,12,0,1,1,380,7134,7514
2018-12-19,4,2018,12,0,2,1,399,7067,7466
2018-12-20,4,2018,12,0,3,1,156,4243,4399
2018-12-21,1,2018,12,0,4,1,469,5227,5696
2018-12-22,1,2018,12,0,5,1,602,3108,3710
2018-12-23,1,2018,12,0,6,0,703,2567,3270
2018-12-24,1,2018,12,0,0,0,435,2057,2492
2018-12-25,1,2018,12,1,1,0,548,1196,1744
2018-12-26,1,2018,12,0,2,1,743,3009,3752
2018-12-27,1,2018,12,0,3,1,1150,4280,5430
2018-12-28,1,2018,12,0,4,1,166,1959,2125
2018-12-29,1,2018,12,0,5,1,1756,4252,6008
2018-12-30,1,2018,12,0,6,0,1295,3634,4929
2018-12-31,1,2018,12,0,0,0,229,2172,2401
2019-01-01,1,2019,1,1,1,0,1083,3457,4540
2019-01-02,1,2019,1,0,2,1,660,5907,6567
2019-01-03,1,2019,1,0,3,1,938,6666,7604
2019-01-04,1,2019,1,0,4,1,848,6514,7362
2019-01-05,1,2019,1,0,5,1,701,4405,5106
2019-01-06,1,2019,1,0,6,0,1149,4901,6050
2019-01-07,1,2019,1,0,0,0,236,5980,6216
2019-01-08,1,2019,1,0,1,1,490,7165,7655
2019-01-09,1,2019,1,0,2,1,280,6128,6408
2019-01-10,1,2019,1,0,3,1,176,5386,5562
2019-01-11,1,2019,1,0,4,1,240,5437,5677
2019-01-12,1,2019,1,0,5,1,365,3264,3629
2019-01-13,1,2019,1,0,6,0,41,587,628
2019-01-14,1,2019,1,0,0,0,70,1452,1522
2019-01-15,1,2019,1,0,1,1,105,3674,3779
2019-01-16,1,2019,1,0,2,1,167,4775,4942
2019-01-17,1,2019,1,0,3,1,158,4927,5085
2019-01-18,1,2019,1,0,4,1,396,5336,5732
2019-01-19,1,2019,1,0,5,1,519,3047,3566
2019-01-20,1,2019,1,0,6,0,246,2344,2590
2019-01-21,1,2019,1,1,0,0,53,1539,1592
2019-01-22,1,2019,1,0,1,1,139,4446,4585
2019-01-23,1,2019,1,0,2,1,264,6444,6708
2019-01-24,1,2019,1,0,3,1,82,3794,3876
2019-01-25,1,2019,1,0,4,1,294,5969,6263
2019-01-26,1,2019,1,0,5,1,559,3935,4494
2019-01-27,1,2019,1,0,6,0,551,3949,4500
2019-01-28,1,2019,1,0,0,0,239,6086,6325
2019-01-29,1,2019,1,0,1,1,127,4208,4335
2019-01-30,1,2019,1,0,2,1,78,3942,4020
2019-01-31,1,2019,1,0,3,1,83,3779,3862
2019-02-01,1,2019,2,0,4,1,43,2424,2467
2019-02-02,1,2019,2,0,5,1,367,3053,3420
2019-02-03,1,2019,2,0,6,0,681,4371,5052
2019-02-04,1,2019,2,0,0,0,550,7247,7797
2019-02-05,1,2019,2,0,1,1,743,8470,9213
2019-02-06,1,2019,2,0,2,1,397,6547,6944
2019-02-07,1,2019,2,0,3,1,523,7328,7851
2019-02-08,1,2019,2,0,4,1,417,6234,6651
2019-02-09,1,2019,2,0,5,1,456,3571,4027
2019-02-10,1,2019,2,0,6,0,468,3456,3924
2019-02-11,1,2019,2,0,0,0,72,3172,3244
2019-02-12,1,2019,2,0,1,1,40,2545,2585
2019-02-13,1,2019,2,0,2,1,270,7033,7303
2019-02-14,1,2019,2,0,3,1,406,7046,7452
2019-02-15,1,2019,2,0,4,1,1147,8030,9177
2019-02-16,1,2019,2,0,5,1,1235,4466,5701
2019-02-17,1,2019,2,0,6,0,796,3195,3991
2019-02-18,1,2019,2,1,0,0,639,3950,4589
2019-02-19,1,2019,2,0,1,1,308,6011,6319
2019-02-20,1,2019,2,0,2,1,32,909,941
2019-02-21,1,2019,2,0,3,1,500,6091,6591
2019-02-22,1,2019,2,0,4,1,619,6564,7183
2019-02-23,1,2019,2,0,5,1,242,2512,2754
2019-02-24,1,2019,2,0,6,0,809,4389,5198
2019-02-25,1,2019,2,0,0,0,239,5683,5922
2019-02-26,1,2019,2,0,1,1,391,7169,7560
2019-02-27,1,2019,2,0,2,1,270,6561,6831
2019-02-28,1,2019,2,0,3,1,433,7010,7443
2019-03-01,1,2019,3,0,4,1,197,3872,4069
2019-03-02,1,2019,3,0,5,1,981,4390,5371
2019-03-03,1,2019,3,0,6,0,234,2075,2309
2019-03-04,1,2019,3,0,0,0,365,5900,6265
2019-03-05,1,2019,3,0,1,1,463,6297,6760
2019-03-06,1,2019,3,0,2,1,190,5347,5537
2019-03-07,1,2019,3,0,3,1,381,6248,6629
2019-03-08,1,2019,3,0,4,1,251,4444,4695
2019-03-09,1,2019,3,0,5,1,1015,4591,5606
2019-03-10,1,2019,3,0,6,0,1533,4997,6530
2019-03-11,1,2019,3,0,0,0,1088,8527,9615
2019-03-12,1,2019,3,0,1,1,748,8187,8935
2019-03-13,1,2019,3,0,2,1,976,8230,9206
2019-03-14,1,2019,3,0,3,1,1823,9755,11578
2019-03-15,1,2019,3,0,4,1,1886,9787,11673
2019-03-16,1,2019,3,0,5,1,2109,6619,8728
2019-03-17,1,2019,3,0,6,0,1868,5792,7660
2019-03-18,1,2019,3,0,0,0,608,7411,8019
2019-03-19,1,2019,3,0,1,1,848,8623,9471
2019-03-20,1,2019,3,0,2,1,896,9094,9990
2019-03-21,2,2019,3,0,3,1,50,2003,2053
2019-03-22,2,2019,3,0,4,1,460,6430,6890
2019-03-23,2,2019,3,0,5,1,1737,5935,7672
2019-03-24,2,2019,3,0,6,0,3025,7858,10883
2019-03-25,2,2019,3,0,0,0,877,8046,8923
2019-03-26,2,2019,3,0,1,1,835,8434,9269
2019-03-27,2,2019,3,0,2,1,931,8871,9802
2019-03-28,2,2019,3,0,3,1,1409,10069,11478
2019-03-29,2,2019,3,0,4,1,1988,10724,12712
2019-03-30,2,2019,3,0,5,1,5784,12127,17911
2019-03-31,2,2019,3,0,6,0,1598,5974,7572
2019-04-01,2,2019,4,0,0,0,826,8039,8865
2019-04-02,2,2019,4,0,1,1,576,7319,7895
2019-04-03,2,2019,4,0,2,1,1888,11254,13142
2019-04-04,2,2019,4,0,3,1,2108,11135,13243
2019-04-05,2,2019,4,0,4,1,537,5371,5908
2019-04-06,2,2019,4,0,5,1,6121,12225,18346
2019-04-07,2,2019,4,0,6,0,4507,10390,14897
2019-04-08,2,2019,4,0,0,0,1390,9565,10955
2019-04-09,2,2019,4,0,1,1,1473,11552,13025
2019-04-10,2,2019,4,0,2,1,1345,11376,12721
2019-04-11,2,2019,4,0,3,1,1153,10699,11852
2019-04-12,2,2019,4,0,4,1,929,8699,9628
2019-04-13,2,2019,4,0,5,1,4204,10414,14618
2019-04-14,2,2019,4,0,6,0,2797,7116,9913
2019-04-15,2,2019,4,0,0,0,1085,7186,8271
2019-04-16,2,2019,4,0,1,1,1863,10035,11898
2019-04-17,2,2019,4,0,2,1,1888,10559,12447
2019-04-18,2,2019,4,0,3,1,2279,10673,12952
2019-04-19,2,2019,4,0,4,1,1308,7064,8372
2019-04-20,2,2019,4,0,5,1,4784,9530,14314
2019-04-21,2,2019,4,0,6,0,3401,7595,10996
2019-04-22,2,2019,4,0,0,0,1736,10473,12209
2019-04-23,2,2019,4,0,1,1,1588,11655,13243
2019-04-24,2,2019,4,0,2,1,1544,11690,13234
2019-04-25,2,2019,4,0,3,1,1711,10628,12339
2019-04-26,2,2019,4,0,4,1,930,7878,8808
2019-04-27,2,2019,4,0,5,1,3189,8863,12052
2019-04-28,2,2019,4,0,6,0,2381,7495,9876
2019-04-29,2,2019,4,0,0,0,1137,9035,10172
2019-04-30,2,2019,4,0,1,1,1166,10635,11801
2019-05-01,2,2019,5,0,2,1,1245,10696,11941
2019-05-02,2,2019,5,0,3,1,1125,8769,9894
2019-05-03,2,2019,5,0,4,1,1718,10746,12464
2019-05-04,2,2019,5,0,5,1,2678,8356,11034
2019-05-05,2,2019,5,0,6,0,318,2371,2689
2019-05-06,2,2019,5,0,0,0,1359,10343,11702
2019-05-07,2,2019,5,0,1,1,1382,10900,12282
2019-05-08,2,2019,5,0,2,1,1234,10385,11619
2019-05-09,2,2019,5,0,3,1,1039,10400,11439
2019-05-10,2,2019,5,0,4,1,1236,9341,10577
2019-05-11,2,2019,5,0,5,1,1809,6428,8237
2019-05-12,2,2019,5,0,6,0,445,2864,3309
2019-05-13,2,2019,5,0,0,0,568,6038,6606
2019-05-14,2,2019,5,0,1,1,1069,9857,10926
2019-05-15,2,2019,5,0,2,1,1372,10956,12328
2019-05-16,2,2019,5,0,3,1,1604,10643,12247
2019-05-17,2,2019,5,0,4,1,2051,11491,13542
2019-05-18,2,2019,5,0,5,1,3465,9391,12856
2019-05-19,2,2019,5,0,6,0,2868,8447,11315
2019-05-20,2,2019,5,0,0,0,1530,9958,11488
2019-05-21,2,2019,5,0,1,1,1381,11429,12810
2019-05-22,2,2019,5,0,2,1,1383,11318,12701
2019-05-23,2,2019,5,0,3,1,1154,10208,11362
2019-05-24,2,2019,5,0,4,1,1887,10675,12562
2019-05-25,2,2019,5,0,5,1,3615,8256,11871
2019-05-26,2,2019,5,0,6,0,3609,7655,11264
2019-05-27,2,2019,5,1,0,0,3227,8032,11259
2019-05-28,2,2019,5,0,1,1,1264,8752,10016
2019-05-29,2,2019,5,0,2,1,1207,10794,12001
2019-05-30,2,2019,5,0,3,1,993,9541,10534
2019-05-31,2,2019,5,0,4,1,1790,11039,12829
2019-06-01,2,2019,6,0,5,1,3105,9127,12232
2019-06-02,2,2019,6,0,6,0,2369,7460,9829
2019-06-03,2,2019,6,0,0,0,1730,11016,12746
2019-06-04,2,2019,6,0,1,1,1633,11977,13610
2019-06-05,2,2019,6,0,2,1,1265,11113,12378
2019-06-06,2,2019,6,0,3,1,1393,11216,12609
2019-06-07,2,2019,6,0,4,1,1903,11647,13550
2019-06-08,2,2019,6,0,5,1,3380,10351,13731
2019-06-09,2,2019,6,0,6,0,1195,4988,6183
2019-06-10,2,2019,6,0,0,0,747,7594,8341
2019-06-11,2,2019,6,0,1,1,1538,11443,12981
2019-06-12,2,2019,6,0,2,1,1450,11171,12621
2019-06-13,2,2019,6,0,3,1,838,8651,9489
2019-06-14,2,2019,6,0,4,1,2035,11613,13648
2019-06-15,2,2019,6,0,5,1,3098,9736,12834
2019-06-16,2,2019,6,0,6,0,2427,7912,10339
2019-06-17,2,2019,6,0,0,0,1039,8983,10022
2019-06-18,2,2019,6,0,1,1,851,8761,9612
2019-06-19,2,2019,6,0,2,1,1303,10936,12239
2019-06-20,2,2019,6,0,3,1,1246,10113,11359
2019-06-21,3,2019,6,0,4,1,2127,11322,13449
2019-06-22,3,2019,6,0,5,1,3532,10292,13824
2019-06-23,3,2019,6,0,6,0,2858,9137,11995
2019-06-24,3,2019,6,0,0,0,1394,9536,10930
2019-06-25,3,2019,6,0,1,1,1350,10984,12334
2019-06-26,3,2019,6,0,2,1,1353,11228,12581
2019-06-27,3,2019,6,0,3,1,1169,10109,11278
2019-06-28,3,2019,6,0,4,1,1638,10292,11930
2019-06-29,3,2019,6,0,5,1,2425,8413,10838
2019-06-30,3,2019,6,0,6,0,2374,8258,10632
2019-07-01,3,2019,7,0,0,0,1532,10854,12386
2019-07-02,3,2019,7,0,1,1,1227,9550,10777
2019-07-03,3,2019,7,0,2,1,1649,10929,12578
2019-07-04,3,2019,7,1,3,0,2865,7469,10334
2019-07-05,3,2019,7,0,4,1,2878,9268,12146
2019-07-06,3,2019,7,0,5,1,2649,7523,10172
2019-07-07,3,2019,7,0,6,0,2199,7849,10048
2019-07-08,3,2019,7,0,0,0,868,7550,8418
2019-07-09,3,2019,7,0,1,1,1383,11589,12972
2019-07-10,3,2019,7,0,2,1,1345,11284,12629
2019-07-11,3,2019,7,0,3,1,776,7892,8668
2019-07-12,3,2019,7,0,4,1,1863,11481,13344
2019-07-13,3,2019,7,0,5,1,2960,9987,12947
2019-07-14,3,2019,7,0,6,0,2441,8447,10888
2019-07-15,3,2019,7,0,0,0,1603,10665,12268
2019-07-16,3,2019,7,0,1,1,1370,10761,12131
2019-07-17,3,2019,7,0,2,1,1000,9296,10296
2019-07-18,3,2019,7,0,3,1,1621,10912,12533
2019-07-19,3,2019,7,0,4,1,1681,10393,12074
2019-07-20,3,2019,7,0,5,1,2295,8156,10451
2019-07-21,3,2019,7,0,6,0,1579,6475,8054
2019-07-22,3,2019,7,0,0,0,1022,9638,10660
2019-07-23,3,2019,7,0,1,1,1072,8671,9743
2019-07-24,3,2019,7,0,2,1,1413,10961,12374
2019-07-25,3,2019,7,0,3,1,1605,11776,13381
2019-07-26,3,2019,7,0,4,1,1986,11554,13540
2019-07-27,3,2019,7,0,5,1,3145,9934,13079
2019-07-28,3,2019,7,0,6,0,2341,8688,11029
2019-07-29,3,2019,7,0,0,0,1467,10685,12152
2019-07-30,3,2019,7,0,1,1,1369,11086,12455
2019-07-31,3,2019,7,0,2,1,1287,10831,12118
2019-08-01,3,2019,8,0,3,1,1503,11319,12822
2019-08-02,3,2019,8,0,4,1,1623,10644,12267
2019-08-03,3,2019,8,0,5,1,2728,9189,11917
2019-08-04,3,2019,8,0,6,0,2508,8830,11338
2019-08-05,3,2019,8,0,0,0,1456,10506,11962
2019-08-06,3,2019,8,0,1,1,1334,10743,12077
2019-08-07,3,2019,8,0,2,1,1257,10102,11359
2019-08-08,3,2019,8,0,3,1,1516,11267,12783
2019-08-09,3,2019,8,0,4,1,1840,11083,12923
2019-08-10,3,2019,8,0,5,1,3094,9617,12711
2019-08-11,3,2019,8,0,6,0,2698,9168,11866
2019-08-12,3,2019,8,0,0,0,1662,10353,12015
2019-08-13,3,2019,8,0,1,1,1071,10221,11292
2019-08-14,3,2019,8,0,2,1,1424,10934,12358
2019-08-15,3,2019,8,0,3,1,1157,9815,10972
2019-08-16,3,2019,8,0,4,1,1599,10710,12309
2019-08-17,3,2019,8,0,5,1,2609,8395,11004
2019-08-18,3,2019,8,0,6,0,1816,7776,9592
2019-08-19,3,2019,8,0,0,0,1095,9450,10545
2019-08-20,3,2019,8,0,1,1,710,8180,8890
2019-08-21,3,2019,8,0,2,1,1091,10577,11668
2019-08-22,3,2019,8,0,3,1,1154,10568,11722
2019-08-23,3,2019,8,0,4,1,732,7444,8176
2019-08-24,3,2019,8,0,5,1,2517,9999,12516
2019-08-25,3,2019,8,0,6,0,2334,9210,11544
2019-08-26,3,2019,8,0,0,0,1182,10503,11685
2019-08-27,3,2019,8,0,1,1,1035,11195,12230
2019-08-28,3,2019,8,0,2,1,1006,10389,11395
2019-08-29,3,2019,8,0,3,1,1318,11386,12704
2019-08-30,3,2019,8,0,4,1,1477,10657,12134
2019-08-31,3,2019,8,0,5,1,2731,8537,11268
2019-09-01,3,2019,9,0,6,0,3070,8935,12005
2019-09-02,3,2019,9,1,0,0,1825,7257,9082
2019-09-03,3,2019,9,0,1,1,997,10875,11872
2019-09-04,3,2019,9,0,2,1,870,10875,11745
2019-09-05,3,2019,9,0,3,1,1028,11530,12558
2019-09-06,3,2019,9,0,4,1,1236,11265,12501
2019-09-07,3,2019,9,0,5,1,2290,10202,12492
2019-09-08,3,2019,9,0,6,0,1981,8755,10736
2019-09-09,3,2019,9,0,0,0,1001,10891,11892
2019-09-10,3,2019,9,0,1,1,987,11552,12539
2019-09-11,3,2019,9,0,2,1,902,10559,11461
2019-09-12,3,2019,9,0,3,1,919,10976,11895
2019-09-13,3,2019,9,0,4,1,1155,11342,12497
2019-09-14,3,2019,9,0,5,1,2231,9722,11953
2019-09-15,3,2019,9,0,6,0,1996,8943,10939
2019-09-16,3,2019,9,0,0,0,948,10766,11714
2019-09-17,3,2019,9,0,1,1,907,11455,12362
2019-09-18,3,2019,9,0,2,1,1032,11855,12887
2019-09-19,3,2019,9,0,3,1,1051,12256,13307
2019-09-20,3,2019,9,0,4,1,1623,12243,13866
2019-09-21,3,2019,9,0,5,1,2602,10629,13231
2019-09-22,3,2019,9,0,6,0,2023,9031,11054
2019-09-23,4,2019,9,0,0,0,955,10637,11592
2019-09-24,4,2019,9,0,1,1,1138,11977,13115
2019-09-25,4,2019,9,0,2,1,1062,11902,12964
2019-09-26,4,2019,9,0,3,1,1173,11795,12968
2019-09-27,4,2019,9,0,4,1,1349,11780,13129
2019-09-28,4,2019,9,0,5,1,2115,9648,11763
2019-09-29,4,2019,9,0,6,0,2014,8616,10630
2019-09-30,4,2019,9,0,0,0,499,8977,9476
2019-10-01,4,2019,10,0,1,1,869,11831,12700
2019-10-02,4,2019,10,0,2,1,827,11110,11937
2019-10-03,4,2019,10,0,3,1,996,11579,12575
2019-10-04,4,2019,10,0,4,1,1303,11879,13182
2019-10-05,4,2019,10,0,5,1,1956,10371,12327
2019-10-06,4,2019,10,0,6,0,1573,8495,10068
2019-10-07,4,2019,10,0,0,0,1118,11564,12682
2019-10-08,4,2019,10,0,1,1,732,11275,12007
2019-10-09,4,2019,10,0,2,1,924,11348,12272
2019-10-10,4,2019,10,0,3,1,1050,11534,12584
2019-10-11,4,2019,10,0,4,1,1450,11326,12776
2019-10-12,4,2019,10,0,5,1,2644,9011,11655
2019-10-13,4,2019,10,0,6,0,1977,7622,9599
2019-10-14,4,2019,10,1,0,0,1617,9656,11273
2019-10-15,4,2019,10,0,1,1,1063,11443,12506
2019-10-16,4,2019,10,0,2,1,321,7510,7831
2019-10-17,4,2019,10,0,3,1,632,9782,10414
2019-10-18,4,2019,10,0,4,1,1258,10117,11375
2019-10-19,4,2019,10,0,5,1,1980,8466,10446
2019-10-20,4,2019,10,0,6,0,139,1396,1535
2019-10-21,4,2019,10,0,0,0,980,10418,11398
2019-10-22,4,2019,10,0,1,1,285,7108,7393
2019-10-23,4,2019,10,0,2,1,860,11275,12135
2019-10-24,4,2019,10,0,3,1,979,11238,12217
2019-10-25,4,2019,10,0,4,1,1352,11229,12581
2019-10-26,4,2019,10,0,5,1,1866,9201,11067
2019-10-27,4,2019,10,0,6,0,1205,6358,7563
2019-10-28,4,2019,10,0,0,0,885,10697,11582
2019-10-29,4,2019,10,0,1,1,741,10916,11657
2019-10-30,4,2019,10,0,2,1,575,8915,9490
2019-10-31,4,2019,10,0,3,1,347,8378,8725
2019-10-01,4,2019,10,0,1,1,869,11831,12700
2019-10-02,4,2019,10,0,2,1,827,11110,11937
2019-10-03,4,2019,10,0,3,1,996,11579,12575
2019-10-04,4,2019,10,0,4,1,1303,11879,13182
2019-10-05,4,2019,10,0,5,1,1956,10371,12327
2019-10-06,4,2019,10,0,6,0,1573,8495,10068
2019-10-07,4,2019,10,0,0,0,1118,11564,12682
2019-10-08,4,2019,10,0,1,1,732,11275,12007
2019-10-09,4,2019,10,0,2,1,924,11348,12272
2019-10-10,4,2019,10,0,3,1,1050,11534,12584
2019-10-11,4,2019,10,0,4,1,1450,11326,12776
2019-10-12,4,2019,10,0,5,1,2644,9011,11655
2019-10-13,4,2019,10,0,6,0,1977,7622,9599
2019-10-14,4,2019,10,1,0,0,1617,9656,11273
2019-10-15,4,2019,10,0,1,1,1063,11443,12506
2019-10-16,4,2019,10,0,2,1,321,7510,7831
2019-10-17,4,2019,10,0,3,1,632,9782,10414
2019-10-18,4,2019,10,0,4,1,1258,10117,11375
2019-10-19,4,2019,10,0,5,1,1980,8466,10446
2019-10-20,4,2019,10,0,6,0,139,1396,1535
2019-10-21,4,2019,10,0,0,0,980,10418,11398
2019-10-22,4,2019,10,0,1,1,285,7108,7393
2019-10-23,4,2019,10,0,2,1,860,11275,12135
2019-10-24,4,2019,10,0,3,1,979,11238,12217
2019-10-25,4,2019,10,0,4,1,1352,11229,12581
2019-10-26,4,2019,10,0,5,1,1866,9201,11067
2019-10-27,4,2019,10,0,6,0,1205,6358,7563
2019-10-28,4,2019,10,0,0,0,885,10697,11582
2019-10-29,4,2019,10,0,1,1,741,10916,11657
2019-10-30,4,2019,10,0,2,1,575,8915,9490
2019-10-31,4,2019,10,0,3,1,347,8378,8725
2019-11-01,4,2019,11,0,4,1,755,9146,9901
2019-11-02,4,2019,11,0,5,1,1687,8336,10023
2019-11-03,4,2019,11,0,6,0,1052,6593,7645
2019-11-04,4,2019,11,0,0,0,681,9195,9876
2019-11-05,4,2019,11,0,1,1,603,10029,10632
2019-11-06,4,2019,11,0,2,1,655,10015,10670
2019-11-07,4,2019,11,0,3,1,539,7782,8321
2019-11-08,4,2019,11,0,4,1,461,7782,8243
2019-11-09,4,2019,11,0,5,1,763,5245,6008
2019-11-10,4,2019,11,0,6,0,1115,6157,7272
2019-11-11,4,2019,11,1,0,0,813,8031,8844
2019-11-12,4,2019,11,0,1,1,132,6168,6300
2019-11-13,4,2019,11,0,2,1,162,6812,6974
2019-11-14,4,2019,11,0,3,1,183,7493,7676
2019-11-15,4,2019,11,0,4,1,428,7928,8356
2019-11-16,4,2019,11,0,5,1,698,5188,5886
2019-11-17,4,2019,11,0,6,0,402,4337,4739
2019-11-18,4,2019,11,0,0,0,230,7204,7434
2019-11-19,4,2019,11,0,1,1,337,8851,9188
2019-11-20,4,2019,11,0,2,1,359,8725,9084
2019-11-21,4,2019,11,0,3,1,314,8843,9157
2019-11-22,4,2019,11,0,4,1,300,7219,7519
2019-11-23,4,2019,11,0,5,1,507,4223,4730
2019-11-24,4,2019,11,0,6,0,447,4344,4791
2019-11-25,4,2019,11,0,0,0,442,7929,8371
2019-11-26,4,2019,11,0,1,1,789,8315,9104
2019-11-27,4,2019,11,0,2,1,462,5788,6250
2019-11-28,4,2019,11,1,3,0,389,1807,2196
2019-11-29,4,2019,11,0,4,1,772,3518,4290
2019-11-30,4,2019,11,0,5,1,576,3456,4032
2019-12-01,4,2019,12,0,6,0,81,1485,1566
2019-12-02,4,2019,12,0,0,0,125,6131,6256
2019-12-03,4,2019,12,0,1,1,203,7920,8123
2019-12-04,4,2019,12,0,2,1,185,7741,7926
2019-12-05,4,2019,12,0,3,1,244,8182,8426
2019-12-06,4,2019,12,0,4,1,385,7950,8335
2019-12-07,4,2019,12,0,5,1,572,5471,6043
2019-12-08,4,2019,12,0,6,0,419,4941,5360
2019-12-09,4,2019,12,0,0,0,64,4818,4882
2019-12-10,4,2019,12,0,1,1,156,6086,6242
2019-12-11,4,2019,12,0,2,1,198,6968,7166
2019-12-12,4,2019,12,0,3,1,240,7072,7312
2019-12-13,4,2019,12,0,4,1,77,4547,4624
2019-12-14,4,2019,12,0,5,1,198,3744,3942
2019-12-15,4,2019,12,0,6,0,497,4823,5320
2019-12-16,4,2019,12,0,0,0,65,3120,3185
2019-12-17,4,2019,12,0,1,1,113,5636,5749
2019-12-18,4,2019,12,0,2,1,139,6594,6733
2019-12-19,4,2019,12,0,3,1,122,5284,5406
2019-12-20,4,2019,12,0,4,1,265,5428,5693
2019-12-21,1,2019,12,0,5,1,242,3089,3331
2019-12-22,1,2019,12,0,6,0,305,2940,3245
2019-12-23,1,2019,12,0,0,0,316,4210,4526
2019-12-24,1,2019,12,0,1,1,326,2611,2937
2019-12-25,1,2019,12,1,2,0,550,1455,2005
2019-12-26,1,2019,12,0,3,1,696,3077,3773
2019-12-27,1,2019,12,0,4,1,939,3977,4916
2019-12-28,1,2019,12,0,5,1,1732,4550,6282
2019-12-29,1,2019,12,0,6,0,211,1198,1409
2019-12-30,1,2019,12,0,0,0,724,4695,5419
2019-12-31,1,2019,12,0,1,1,650,5096,5746
